H|20131120
AAON|AAON INC NEW
AIR|AAR CORP
ABB|ABB LTD
ACCO|ACCO BRANDS CORPORATION
ABM|ABM INDUSTRIES INC
ADT|ADT CORPORATION (THE)
AEPI|AEP INDUSTRIES INC
AFCE|AFC ENTERPRISES INC
AFL|AFLAC INCORPORATED
AFSD|AFLAC INCORPORATED
AGCO|AGCO CORP
GAS|AGL RESOURCES INC
MITT|AG MTG INVT TR INC
AHC|A. H. BELO CORPORATION
AES|AES CORP.
AAGIY|AIA GROUP LIMITED
ALCS|ALCO STORES INC
AMAG|AMAG PHARMACEUTICALS, INC.
AMCX|AMC NETWORKS INC.
AHS|AMN HEALTHCARE SERVICES INC
AOL|AOL INC.
ATNY|API TECHNOLOGIES CORP.
ARC|ARC DOCUMENT SOLUTIONS INC
T|AT&T INC
ATMI|ATMI INC
AUO|AU OPTRONICS CORP.
AVHI|AV HOMES INC
AVX|AVX CORPORATION NEW
AXTI|AXT INC
AZZ|AZZ INC
AAN|AARON RENTS INC A
ABAX|ABAXIS INC
ABT|ABBOTT LABORATORIES
ABBV|ABBVIE INC.
ISL|ABERDEEN ISRAEL FUND
ETF|ABERDEEN EMERGING MARKETS
IF|ABERDEEN INDONESIA FUND INC
LAQ|ABERDEEN LATIN
SGF|ABERDEEN SINGAPORE
ABMD|ABIOMED INC
AXAS|ABRAXAS PETROLEUM CORPORATION
ACTG|ACACIA RESEARCH CORPORATION
ACHC|ACADIA HEALTHCARE COMPANY INC
ACAD|ACADIA PHARMACEUTICALS INC.
AKR|ACADIA REALTY TRUST
ACCL|ACCELRYS INC
XLRN|ACCELERON PHARMA INC
ACMP|ACCESS MIDSTREAM PARTNERS L P
AH|ACCRETIVE HEALTH INC
ARAY|ACCURAY INC
ACW|ACCURIDE CORP
ACET|ACETO CORP
ACHN|ACHILLION PHARMACEUTICALS INC
ACIW|ACI WORLDWIDE INC
ACOR|ACORDA THERAPEUTICS INC
ACPW|ACTIVE POWER INC
ATVI|ACTIVISION BLIZZARD INC
BIRT|ACTUATE CORPORATION
ATU|ACTUANT CORP
AYI|ACUITY BRANDS INC
ACXM|ACXIOM CORP
ADX|ADAMS EXPRESS CO.
AE|ADAMS RESOURCES & ENERGY INC
ADUS|ADDUS HOMECARE CORP
ADEP|ADEPT TECHNOLOGY INC
ADBE|ADOBE SYSTEMS INC
ADTN|ADTRAN INC
AAP|ADVANCE AUTO PARTS, INC.
ASX|ADVANCED SEMICONDUCTOR ENG INC
ABCO|ADVISORY BRD CO
AAV|ADVANTAGE OIL & GAS LTD
ACM|AECOM TECHNOLOGY CORPORATION
AEGR|AEGERION PHARMACEUTICALS, INC.
ADES|ADVANCED EMISSIONS
AEGN|AEGION CORPORATION
ARX|AEROFLEX HOLDING CORP.
AEG|AEGON N V AMER REG
AED|AEGON NV
AEB|AEGON NV
AEIS|ADVANCED ENERGY INDUSTRIES INC
ADVS|ADVENT SOFTWARE INC
AVAV|AEROVIRONMENT, INC.
AET|AETNA INC
AMG|AFFILIATED MANAGERS GROUP INC
AFFX|AFFYMETRIX INC
A|AGILENT TECHNOLOGIES, INC.
AEM|AGNICO EAGLE MINES LTD
AGYS|AGILYSYS INC
AGIO|AGIOS PHARMACEUTICALS, INC.
ADC|AGREE REALTY CORP
AGU|AGRIUM INC
AFLYY|AIR FRANCE-KLM
AIQUY|AIR LIQUIDE ADR
AIRM|AIR METHODS CORP NEW
AL|AIR LEASE CORPORATION
APD|AIR PRODUCTS & CHEMICALS INC
ATSG|AIR TRANSPORT SERVICES GROUP I
ARG|AIRGAS INC
AKAM|AKAMAI TECHNOLOGIES INC
AKRX|AKORN INC
ALG|ALAMO GROUP INC
AGI|ALAMOS GOLD INC
ALK|ALASKA AIR GROUP INC(DEL HLDG)
ALSK|ALASKA COMMUNICATIONS SYSTEMS
AIN|ALBANY INTERNATIONAL CORP
AMRI|ALBANY MOLECULAR RESEARCH
ALB|ALBEMARLE CORP
ALEX|ALEXANDER & BALDWIN, INC.
ALR|ALERE INC
ALX|ALEXANDERS INC.
ARE|ALEXANDRIA REAL ESTATE
AREPRE|ALEXANDRIA REAL ESTATE EQ INC.
ALXN|ALEXION PHARMACEUTICALS INC
AXU|ALEXCO RESOURCE CORP.
ALXA|ALEXZA PHARMACEUTICALS, INC.
ALCO|ALICO INC
ALGN|ALIGN TECHNOLOGY INC
Y|ALLEGHANY CORP (DELAWARE)
ATI|ALLEGHENY TECHNOLOGIES INC
ALGT|ALLEGIANT TRAVEL CO
AGN|ALLERGAN INC
ALE|ALLETE INC.
ADS|ALLIANCE DATA SYSTEMS CORPORAT
AIQ|ALLIANCE HEALTHCARE
AHGP|ALLIANCE HOLDINGS GP LP
AOI|ALLIANCE ONE INTL INC.
LNT|ALLIANT ENERGY CORPORATION
ATK|ALLIANT TECHSYSTEMS INC
AZSEY|ALLIANZ SE
ACG|ALLIANCEBERNSTEIN INCOME
NCZ|ALLIANZGI CONVERTIBLE
NCV|ALLIANZGI CONVERTIBLE
NIE|ALLIANZGI EQUITY & CONV
ALLB|ALLIANCE BANCORP INC
ALSN|ALLISON TRANSMISSION HLDG INC.
MDRX|ALLSCRIPTS HEALTHCARE SOL INC
ALL|ALLSTATE CORPORATION
ALLPRB|THE ALLSTATE CORPORATION
ALLPRC|THE ALLSTATE CORPORATION
ALLYPRB|ALLY FINANCIAL INC.
AFAM|ALMOST FAMILY INC
ALNY|ALNYLAM PHARMACEUTICALS, INC.
ALJ|ALON USA ENERGY, INC
ANR|ALPHA NATURAL RESOURCES, INC.
ATEC|ALPHATEC HOLDINGS INC.
AOD|ALPINE TOTAL DYNAMIC DIVID FD
ALSMY|ALSTOM
ALTR|ALTERA CORP
ALTV|ALTEVA
RESI|ALTISOURCE RESIDENTIAL CORPORA
AIMC|ALTRA HOLDINGS, INC.
MO|ALTRIA GROUP, INC.
AWC|ALUMINA LIMITED
AMZN|AMAZON.COM INC
AMBC|AMBAC FINANCIAL GROUP, INC.
EPAX|AMBASSADORS GROUP INC
ABEV|AMBEV S A
DIT|AMCON DISTRG CO
ACO|AMCOL INTERNATIONAL CORP
AMED|AMEDISYS INC
UHAL|AMERCO
AEE|AMEREN CORPORATION
AMRC|AMERESCO, INC.
AMX|AMERICA MOVIL SAB DE CV
AAT|AMERICAN ASSETS TRUST, INC.
AXL|AMERICAN AXLE & MFG HOLDINGS
ACC|AMERICAN CAMPUS CMNTYS, INC
AGNC|AMERICAN CAPITAL AGENCY CORP.
AGNCP|AMERICAN CAPITAL AGY CORP.
ACAS|AMERICAN CAPITAL, LTD.
MTGE|AMERICAN CAPITAL MORTGAGE
AEP|AMERICAN ELECTRIC POWER INC
AEO|AMERICAN EAGLE OUTFITTERS INC
AETI|AMERICAN ELECTRIC
AEL|AMERICAN EQTY INVSTMNT LFE HLD
AXP|AMERICAN EXPRESS CO.
AFG|AMERICAN FINANCIAL GROUP INC
AMH|AMERICAN HOMES 4 RENT LLC
AIG|AMERICAN INTL GROUP, INC.
AMNB|AMERICAN NATIONAL BANKSHARES
ANAT|AMERICAN NATL INS CO
APFC|AMERICAN PAC CORP
APEI|AMERICAN PUBLIC EDUCATION INC.
ARII|AMERICAN RAILCAR INDUSTRIES, I
ARPI|AMERICAN RESIDENTIAL PROPERTIE
ASEI|AMER.SCIENCE & ENG.INC.
AMSWA|AMERICAN SOFTWARE CL-A
AWR|AMERICAN STATES WATER CO
AMSC|AMERICAN SUPERCONDUCTOR CORP
AMT|AMERICAN TOWER CORPORATION
AVD|AMERICAN VANGUARD CORPORATION
AWK|AMERICAN WATER WORKS CO, INC.
AMWD|AMERICAN WOODMARK CORP
CRMT|AMERICAS CAR MART INC
APEOF|AMERICAS PETROGAS INC.
AMSF|AMERISAFE, INC
ABC|AMERISOURCEBERGEN CORPORATION
ASRV|AMERISERV FINL INC
AMP|AMERIPRISE FINANCIAL, INC.
AMPPRA|AMERIPRISE FINANCIAL, INC.
ABCB|AMERIS BANCORP
ATLO|AMES NATL CORP
AME|AMETEK INC (NEW)
AMGN|AMGEN INC.
FOLD|AMICUS THERAPEUTICS INC
AMKR|AMKOR TECHNOLOGIES INC
AP|AMPCO PITTSBURG CORP
APH|AMPHENOL CORP CL-A (NEW)
AXR|AMREP CORP
AMRE|AMREIT INC NEW
AMSG|AMSURG CORPORATION
ASYS|AMTECH SYSTEMS INC
AFSI|AMTRUST FINANCIAL SERVICES INC
ANAC|ANACOR PHARMACEUTICALS, INC.
APC|ANADARKO PETROLEUM CORP
ANAD|ANADIGICS INC.
ADI|ANALOG DEVICES, INC.
ALOG|ANALOGIC CORP (NEW)
ANEN|ANAREN INC
ANDE|ANDERSONS INC
ANGO|ANGIODYNAMICS, INC.
AAUKY|ANGLO AMERICAN PLC
AU|ANGLOGOLD ASHANTI LIMITED
BUD|ANHEUSER-BUSCH INBEV S.A.
ANIK|ANIKA THERAPEUTICS INC
AXE|ANIXTER INTERNATIONAL INC
ANN|ANN INC
NLY|ANNALY CAPITAL MANAGEMENT, INC
NLYPRC|ANNALY CAPITAL MGMT INC
NLYPRD|ANNALY CAPITAL MANAGEMENT, INC
BNNY|ANNIES INC
ANSS|ANSYS INC
ATRS|ANTARES PHARMA, INC.
AR|ANTERO RESOURCES CORPORATION
ANH|ANWORTH MORTGAGE ASSET CORP
APA|APACHE CORP.
AIV|APARTMENT INVT & MGMT CO CL-A
APOG|APOGEE ENTERPRISES INC
APOL|APOLLO EDUCATION
APO|APOLLO GLOBAL MANAGEMENT, LLC
AINV|APOLLO INVESTMENT CORPORATION
ARI|APOLLO COML REAL EST FIN INC
AMTG|APOLLO RESIDENTIAL MORT INC
AMTGPRA|APOLLO RESIDNTIL MRTGGE,INC.
AAPL|APPLE, INC.
AIT|APPLIED INDUSTRIAL TECHNOLOGY
AMAT|APPLIED MATERIALS INC
AMCC|APPLIED MICRO CIRCUITS CORP
AAOI|APPLIED OPTOELECTRONICS, INC.
ATR|APTARGROUP INC
WTR|AQUA AMERICA INC
ARSD|ARABIAN AMER DEVELOPMENT CO
PETX|ARATANA THERAPEUTICS, INC.
ABR|ARBOR REALTY TRUST, INC.
ADM|ARCHER DANIELS MIDLAND CO
ACAT|ARCTIC CAT INC
ARDNA|ARDEN GROUP INC CL-A
ARCC|ARES CAPITAL CORPORATION
ARY|ARES CAPITAL CORPORATION
ACRE|ARES COMMERCIAL REAL ESTATE CO
ARKR|ARK RESTAURANTS CORP
ABFS|ARKANSAS BEST CORP DEL
AI|ARLINGTON ASSET INVESTMENT COR
ARMH|ARM HOLDINGS PLC SPON ADR
AHH|ARMADA HOFFLER PROPERTIES INC.
ARR|ARMOUR RESIDENTIAL REIT INC
ARRPRA|ARMOUR RESIDENTIAL REIT, INC.
AWI|ARMSTRONG WORLD
ARQL|ARQULE INC
ARRY|ARRAY BIOPHARMA INC
ARRS|ARRIS GROUP, INC.
ARW|ARROW ELECTRONICS INC.
AROW|ARROW FINANCIAL CORP
ARWR|ARROWHEAD RESEARCH CORP
ARTNA|ARTESIAN RESOURCES CORP
ARTC|ARTHROCARE CORPORATION
APAM|ARTISAN PARTNERS ASSET MGMT IN
ARUN|ARUBA NETWORKS, INC.
AHKSY|ASHAI KASEI CORP
AKG|ASANKO GOLD INC
ABG|ASBURY AUTOMOTIVE GROUP, INC.
ASNA|ASCENA RETAIL GROUP INC
ASCMA|ASCENT CAPITAL GROUP INC
AHT|ASHFORD HOSPITALITY TRUST INC
AHTPRD|ASHFORD HOSPITALITY TRUST INC
ASH|ASHLAND INC.
ASIA|ASIAINFO-LINKAGE INC
AZPN|ASPEN TECHNOLOGY INC
ASAZY|ASSA ABLOY AB
ASBC|ASSOCIATED BANC CORP
ASBFY|ASSOCIATED BRITISH FOOD PLC
AEC|ASSOCIATED ESTATES REALTY CORP
AIZ|ASSURANT, INC.
ASFI|ASTA FUNDING INC
ASTE|ASTEC INDUSTRIES INC
ALPMY|ASTELLAS PHARMA INC.
AF|ASTORIA FINANCIAL CORP
AZN|ASTRAZENECA PLC SPONS ADR
ALOT|ASTRO MED INC NEW
ATRO|ASTRONICS CORP
ATHN|ATHENAHEALTH, INC.
ATHL|ATHLON ENERGY INC.
AAME|ATLANTIC AMERICAN CORP
AT|ATLANTIC POWER CORPORATION
ATNI|ATLANTIC TELE-NETWORK, INC.
AAWW|ATLAS AIR WORLDWIDE HOLDINGS
ATLKY|ATLAS COPCO AB SPONS ADR NEW
ATLS|ATLAS ENERGY LP
ATL|ATLATSA RES CORP
ATML|ATMEL CORP.
ATO|ATMOS ENERGY CORPORATION
ATRC|ATRICURE, INC.
ATRI|ATRION CORP
ATW|ATWOOD OCEANICS INC
ADNC|AUDIENCE INC
AUQ|AURICO GOLD INC
ANZBY|AUSTRALIA & NEWZEALAND BANKING
ABTL|AUTOBYTEL INC
ADSK|AUTODESK INC
ALV|AUTOLIV, INC.
ADP|AUTOMATIC DATA PROCESSING INC
AN|AUTONATION, INC.
AZO|AUTOZONE, INC.
AUXL|AUXILIUM PHARMACEUTICALS. INC.
AVB|AVALONBAY COMMUNITIES INC
AVNR|AVANIR PHARMACEUTICALS INC
AVEO|AVEO PHARMACEUTICALS INC
AVY|AVERY DENNISON CORPORATION
AVNW|AVIAT NETWORKS INC
AVID|AVID TECHNOLOGY INC
CAR|AVIS BUDGET GROUP, INC.
AVA|AVISTA CORP
AVT|AVNET INC.
AVIV|AVIV REIT INC MD
AVV|AVIVA PLC
AVP|AVON PRODUCTS INC.
AXAHY|AXA-UAP
AWRE|AWARE INC MASS
ACLS|AXCELIS TECHNOLOGIES, INC.
AXLL|AXIALL CORP
BBT|BB&T CORPORATION
BBTPRE|BB&T CORPORATION
BGS|B&G FOODS, INC.
BACPRZ|PFD 6.0000 08/25/2035
BAESY|BAE SYSTEMS PLC
BASFY|BASF SE ADR
BCBP|BCB BANCORP INC
BCE|BCE INC.
BBX|BBX CAP CORP
BGCP|BGC PARTNERS, INC
BRGYY|BG GROUP PLC SPON ADR
BBL|BHP BILLITON PLC
BIND|BIND THERAPEUTICS INC
BOKF|BOK FINANCIAL CORP (NEW)
BP|BP P.L.C.
BPZ|BPZ RESOURCES, INC
BRE|BRE PROPERTIES, INC.
BNPQY|BNP PARIBAS
BOFI|BOFI HOLDING, INC.
BLMT|BSB BANCORP INC
BTUI|BTU INTERNATIONAL INC.
BWC|BABCOCK & WILCOX COMPANY (THE)
BMI|BADGER METER INC
BIDU|BAIDU, INC.
BHI|BAKER HUGHES INC
BCPC|BALCHEM CORPORATION
BWINB|BALDWIN & LYONS INC CL-B
BLL|BALL CORPORATION
BTN|BALLANTYNE OF OMAHA INC
BYI|BALLY TECHNOLOGIES INC
BANF|BANCFIRST CORP
BBD|BANCO BRADESCO S.A.
BDORY|BANCO DO BRASIL S.A.
BSAC|BANCO SANTANDER-CHILE
BSBR|BANCO SANTANDER BRASIL SA
CIB|BANCOLOMBIA S.A.
BXS|BANCORPSOUTH INC
TBBK|THE BANCORP INC
BANC|BANC OF CALIFORNIA INC
BAC|BANK OF AMERICA CORP
BMLPRJ|BANK OF AMERICA CORPORATION
BMLPRI|BANK OF AMERICA
BACPRL|BANK OF AMERICA CORPORATION
BACPRI|BANK OF AMERICA CORPORATION
BACPRD|BANK OF AMERICA CAPITAL CORP
BOH|BANK OF HAWAII CORPORATION
BKYF|BANK OF KENTUCKY FINANCIAL COR
BMRC|BANK OF MARIN BANCORP
BMO|BANK OF MONTREAL
BKMU|BANK MUTUAL CORPORATION
OZRK|BANK OF THE OZARKS INC
BK|THE BANK OF NY MELLON CORP
BKPRC|THE BANK OF NEW YORK MELLON
BNS|BANK OF NOVA SCOTIA
BFIN|BANKFINANCIAL CORP.
RATE|BANKRATE, INC.
BKU|BANKUNITED INC
BANR|BANNER CORPORATION
BHB|BAR HARBOR BANKSHARES
BCR|BARD C R INC N J
BCSPR|BARCLAYS BANK PLC
BCSPRD|BARCLAYS BANK PLC
FIGY|FI ENHANCED GLOBAL HIGH YLD
BKS|BARNES & NOBLE, INC
B|BARNES GROUP INC
ABX|BARRICK GOLD CORPORATION
BRN|BARNWELL INDUSTRIES INC.
BBSI|BARRETT BUSINESS SERVICES INC
DFZ|BARRY R G CORP (OHIO)
BAS|BASIC ENERGY SERVICES INC
BSET|BASSETT FURNITURE
BAX|BAXTER INTERNATIONAL INC
BAYRY|BAYER AG-SPONSORED ADR
BAMXY|BAYERISCHE MOTOREN WERKE AKTIE
BTE|BAYTEX ENERGY TR
BV|BAZAARVOICE INC
BBCN|BBCN BANCORP INC
BEAV|B/E AEROSPACE INC
BECN|BEACON ROOFING SUPPLY, INC.
BEAM|BEAM INC
BCEKF|BEAR CREEK MINING CORPORATION
BZT|BEAZER HOMES USA, INC.
BEBE|BEBE STORES INC
BDX|BECTON DICKINSON & CO
BBBY|BED BATH & BEYOND INC.
BELFA|BEL FUSE INC CL-A
BELFB|BEL FUSE INC CL-B
BDC|BELDEN INC
BXE|BELLATRIX EXPLORATION LTD.
BLC|BELO CORPORATION
BMS|BEMIS COMPANY
BHE|BENCHMARK ELECTRONICS INC
BNCL|BENEFICIAL MUTUAL BANCORP INC.
BNFT|BENEFITFOCUS, INC.
WRB|W.R. BERKLEY CORPORATION
WRBPRB|W. R. BERKLEY CORPORATION
BRKA|BERKSHIRE HATHAWAY INC CL-A
BRKB|BERKSHIRE HATHAWAY INC.
BHLB|BERKSHIRE HILLS BANCORP INC.
BRY|BERRY PETROLEUM CO CL-A
BERY|BERRY PLASTICS GROUP, INC.
BBY|BEST BUY CO INC
BHP|BHP BILLITON LIMITED
BDVSY|BIDVEST GROUP LIMITED
BGFV|BIG 5 SPORTING GOODS CORP
BIG|BIG LOTS INC
BH|BIGLARI HOLDINGS INC
BIO|BIO-RAD LABORATORIES, INC
BCRX|BIOCRYST PHARMACEUTICALS INC
BDSI|BIODELIVERY SCIENCES INTL, INC
BMRN|BIOMARIN PHARMACEUTICAL INC
BIIB|BIOGEN IDEC INC.
BMR|BIOMED REALTY TRUST INC
BEAT|BIOTELEMETRY INC
BIOS|BIOSCRIP, INC.
BSTC|BIOSPECIFICS TECHNOLOGIES CORP
BJRI|BJS RESTAURANTS INC
BBOX|BLACK BOX CORP (DE)
BDE|BLACK DIAMOND INC
BKH|BLACK HILLS CORP
BLKB|BLACKBAUD INC
HAWK|BLACKHAWK NETWORK HOLDINGS,INC
BKT|BLACKROCK INCOME
BLK|BLACKROCK, INC.
BOE|BLACKROCK GLOBAL OPPORTUNITIES
BDJ|BLACKROCK ENHANCED EQ
BKCC|BLACKROCK KELSO CAPITAL CORP
BX|BLACKSTONE GROUP L.P. (THE)
MYN|BLACKROCK MUNIYIELD NY
BCX|BLACKROCK RESOURCES & COMMODIT
BXMT|BLACKSTONE MORTGAGE TRUST INC
HRB|H & R BLOCK INC.
BLMN|BLOOMIN' BRANDS, INC.
BLT|BLOUNT INTERNATIONAL INC
BCOR|BLUCORA INC
NILE|BLUE NILE, INC.
BXC|BLUELINX HOLDINGS INC.
BOBE|BOB EVANS FARMS, INC.
BA|BOEING COMPANY
WIFI|BOINGO WIRELESS, INC.
BCC|BOISE CASCADE, L.L.C.
BOLT|BOLT TECHNOLOGY CORPORATION
BDRAF|BOMBARDIER INC.
BCEI|BONANZA CREEK ENERGY, INC.
BAH|BOOZ ALLEN HAMILTON HOLDING
BWA|BORGWARNER INC.
SAM|BOSTON BEER INC CL A
BPFH|BOSTON PRIVATE FINANCIAL
BXP|BOSTON PROPERTIES INC
BSX|BOSTON SCIENTIFIC CORP.
EPAY|BOTTOMLINE TECHNOLOGIES INC
BDBD|BOULDER BRANDS INC
BIF|BOULDER GROWTH & INCOME FD INC
BWLA|BOWL AMERICAN INC.
BYD|BOYD GAMING CORPORATION
BRC|BRADY CORP CLASS-A
BDN|BRANDYWINE REALTY TRUST NEW
BDNPRE|BRANDYWINE REALTY TRUST
BRFS|BRF SA
BAK|BRASKEM S.A.
BBRG|BRAVO BRIO RESTAURANT GROUP IN
BBNK|BRIDGE CAPITAL HOLDINGS
BPI|BRIDGEPOINT EDUCATION INC.
BGG|BRIGGS & STRATTON CORP.
BCOV|BRIGHTCOVE INC.
EAT|BRINKER INTERNATIONAL INC
BCO|BRINK'S COMPANY (THE)
BMY|BRISTOL-MYERS SQUIBB COMPANY
BRS|BRISTOW GROUP INC.
BRCM|BROADCOM CORP CL-A
BSFT|BROADSOFT, INC.
BR|BROADRIDGE FINANCIAL
BWEN|BROADWIND ENERGY INC.
BRCD|BROCADE COMMUNICATIONS SYSTEMS
BKD|BROOKDALE SENIOR LIVING, INC.
BAM|BROOKFIELD ASSET MANAGEMENT IN
DTLAPR|BROOKFIELD DTLA FD OFFICE TR I
BOXC|BROOKFIELD CANADA OFFICE
HTR|BROOKFIELD TOTAL RETURN FD INC
BRP|BROOKFIELD RESIDENTIAL
BPO|BROOKFIELD OFFICE PROP INC
BRKL|BROOKLINE BANCORP INC
BRKS|BROOKS AUTOMATION INC
BRO|BROWN & BROWN INC
BFA|BROWN FORMAN CORP CL A
BFB|BROWN FORMAN CORP CL B
BWS|BROWN SHOE COMPANY INC
BRKR|BRUKER CORPORATION
BC|BRUNSWICK CORP.
BMTC|BRYN MAWR BK CORP
BSQR|BSQUARE CORPORATION
BTG|B2GOLD CORP
BKE|BUCKLE INC COM
BWLD|BUFFALO WILD WINGS, INC.
BBW|BUILD-A-BEAR WORKSHOP, INC.
BLDR|BUILDERS FIRSTSOURCE, INC.
BKW|BURGER KING WORLDWIDE INC
BURL|BURLINGTON STORES INC
CJES|C&J ENERGY SERVICES, INC
CAE|CAE INC
CAP|CAI INTERNATIONAL, INC.
CBZ|CBIZ, INC.
CBL|CBL & ASSOC PROPERTIES, INC.
CBLPRD|CBL & ASSOC PROPERTIES,INC.
CBLPRE|CBL & ASOCITES PROPETIES INC.
CBSA|CBS CORPORATION
CBS|CBS CORPORATION
CBOE|CBOE HOLDINGS, INC.
IGR|CBRE CLARION GLBAL REAL ESTAT
CBG|CBRE GROUP INC
CDI|C D I CORP
CEC|CEC ENTERTAINMENT INC
CECE|CECO ENVIRONMENTAL CORP
CDW|CDW CORP
CF|CF INDUSTRIES HOLDINGS, INC.
CGG|COMPAGNIE GENERALE DE GEOPHYSI
CHRW|C.H. ROBINSON WORLDWIDE INC.
CIFC|CIFC CORP
CI|CIGNA CORPORATION
CIT|CIT GROUP INC.
CNL|CLECO CORPORATION
CME|CME GROUP INC.
CMS|CMS ENERGY CORPORATION
CSS|CSS INDUSTRIES
CVU|CPI AEROSTRUCTURES INC (NEW)
CNA|CNA FINCL.CORP.
CEO|CNOOC LIMITED
CPL|CPFL ENERGIA, S.A.
CRAI|CRA INTERNATIONAL, INC.
CNO|CNO FINANCIAL GROUP INC
CRH|CRH PLC SPON ADR
CSGS|CSG SYSTEMS INTL INC
CMXHY|CSL LIMITED
CSPI|CSP INC
CSX|CSX CORPORATION
CTCM|CTC MEDIA INC
CST|CST BRANDS, INC.
CTS|CTS CORPORATION
CUNB|CU BANCORP
CVBF|C V B FINL CORP
CVI|CVR ENERGY, INC.
CVS|CVS CAREMARK CORPORATION
CYS|CYS INVESTMENTS INC
CYSPRB|CYS INVESTMENTS, INC
CA|CA, INC.
CAB|CABELA'S INCORPORATED
CVC|CABLEVISION SYSTEMS CORP
CBT|CABOT CORP.
COG|CABOT OIL & GAS CORPORATION
CCMP|CABOT MICROELECTRONICS CORP
CACH|CACHE INC NEW
CACI|CACI INTERNATIONAL INC
CDNS|CADENCE DESIGN SYSTEMS INC
CADX|CADENCE PHARMACEUTICALS INC.
CZR|CAESARS ENTERTAINMENT CORP
DVR|CAL DIVE INTERNATIONAL, INC.
CALM|CAL-MAINE FOODS INC
CLMS|CALAMOS ASSET MANAGEMENT, INC.
CAMP|CALAMP CORP
CVGW|CALAVO GROWERS INC
CCC|CALGON CARBON CORPORATION
CWT|CALIFORNIA WATER SERVICE GROUP
CALX|CALIX, INC.
ELY|CALLAWAY GOLF
CALD|CALLIDUS SOFTWARE INC
CPE|CALLON PETROLEUM CO
CPN|CALPINE CORPORATION
CBM|CAMBREX CORPORATION
ABCD|CAMBIUM LEARNING GROUP, INC.
CAC|CAMDEN NATIONAL CORP
CPT|CAMDEN PROPERTY TRUST
CCJ|CAMECO CORPORATION
CAM|CAMERON INTERNATIONAL CORP
CPB|CAMPBELL SOUP CO
CCG|CAMPUS CREST COMMUNITIES, INC.
CCGPRA|CAMPUS CREST COMMUNITIES, INC.
CM|CANADIAN IMPERIAL BANK OF
CNI|CANADIAN NATIONAL RAILWAY CO.
CNQ|CANADIAN NATURAL RESOURCES
CP|CANADIAN PACIFIC RAILWAY LTD
CMN|CANTEL MEDICAL CORP.
CPHC|CANTERBURY PARK HOLDING CORPOR
CPLA|CAPELLA EDUCATION COMPANY
CCBG|CAPITAL CITY BANK GROUP INC
CBF|CAPITAL BANK FINANCIAL CORP.
COF|CAPITAL ONE FINANCIAL CORP
COFWS|WTS/CAPITAL ONE FINANCIAL CORP
COFPRP|CAPITAL ONE FINANCIAL CORP
CSU|CAPITAL SENIOR LIVING CORP
CSWC|CAPITAL SOUTHWEST CORP
CSE|CAPITALSOURCE INC.
CFFN|CAPITOL FEDERAL FINANCIAL INC
CPMK|CAPMARK FINANCIAL GROUP INC.
CPST|CAPSTONE TURBINE CORP
CMO|CAPSTEAD MORTGAGE CORPORATION
CARB|CARBONITE INC
CFNL|CARDINAL FINANCIAL CORP
CAH|CARDINAL HEALTH INC
CSII|CARDIOVASCULAR SYSTEMS INC
CATM|CARDTRONICS, INC
CECO|CAREER EDUCATION CORP
CFN|CAREFUSION CORPORATION
CSL|CARLISLE COS INC
CABGY|CARLSBERG AS
CG|CARLYLE GROUP L.P. (THE)
KMX|CARMAX, INC.
CKEC|CARMIKE CINEMAS INC
CCL|CARNIVAL CORPORATION
CSV|CARRIAGE SERVICES, INC.
CRS|CARPENTER TECHNOLOGY INC
CRZO|CARRIZO OIL & GAS INC
TAST|CARROLS RESTAURANT GROUP INC
CRI|CARTER'S, INC.
CSCD|CASCADE MICROTECH, INC.
CWST|CASELLA WASTE SYSTEMS INC
CASY|CASEY'S GENERAL STORES,INC
CSH|CASH AMER INTL INC
CASS|CASS INFORMATION SYSTEMS INC
CAS|A.M.CASTLE & CO
CTRX|CATAMARAN CORP
CAT|CATERPILLAR INC (DELAWARE)
CATY|CATHAY GENERAL BANCORP
CATO|CATO CORPORATION (THE)
CVCO|CAVCO INDUSTRIES INC
CAVM|CAVIUM INC
CBEY|CBEYOND,  INC.
FUN|CEDAR FAIR, L.P.
CDR|CEDAR REALTY TRUST INC
CGI|CELADON GROUP INC.
CE|CELANESE CORPORATION
CLS|CELESTICA INC.
CELG|CELGENE CORPORATION
CLDX|CELLDEX THERAPEUTICS, INC
CPAC|CEMENTOS PACASMAYO S.A.A.
CX|CEMEX, S.A.B DE C.V.
CEMP|CEMPRA INC
CNC|CENTENE CORPORATION
CVE|CENOVUS ENERGY INC.
CNBC|CENTER BANCORP INC
CNP|CENTERPOINT ENERGY, INC.
CSFL|CENTERSTATE BANKS INC
EBR|CENTRAIS ELETRICAS BRASILEIRAS
CEE|THE CENTRAL EUROPE RUSSIA
CEF|CENTRAL FD CDA LTD
CENT|CENTRAL GARDEN & PET CO
CENTA|CENTRAL GARDEN & PET COMPANY
CPF|CENTRAL PACIFIC FINANCIAL CORP
CENX|CENTURY ALUMINUM COMPANY
CNTY|CENTURY CASINOS INC
CTL|CENTURYLINK INC
CPHD|CEPHEID INC
CVO|CENVEO INC
CERN|CERNER CORP
CERS|CERUS CORPORATION
CEVA|CEVA INC
CSG|CHAMBERS STREET PROPERTIES
ECOM|CHANNELADVISOR CORPORATION
CTHR|CHARLES & COLVARD LTD
CRL|CHARLES RIV LABS INTL INC
GTLS|CHART INDUSTRIES, INC.
CHTR|CHARTER COMMUNICATIONS, INC.
CHFN|CHARTER FINL CORP MD
CCF|CHASE CORP
CLDT|CHATHAM LODGING TR
CKP|CHECKPOINT SYS INC
CAKE|CHEESECAKE FACTORY INCORPORATE
CHEF|THE CHEF'S WAREHOUSE INC
CHFC|CHEMICAL FINL CORP
CHMT|CHEMTURA CORPORATION
CHMG|CHEMUNG FINANCIAL CORP
LNG|CHENIERE ENERGY INC
CHKE|CHEROKEE INC (NEW)
CHMI|CHERRY HILL MORTGAGE INVESTMEN
CHK|CHESAPEAKE ENERGY CORPORATION
CHSP|CHESAPEAKE LODGING TRUST
CPK|CHESAPEAKE UTILITIES CORP
CHEUY|CHEUNG KONG HLDGS LTD (ADR)
CVX|CHEVRON CORPORATION
CBI|CHICAGO BRIDGE & IRON COMPANY
CVR|CHICAGO RIVET & MACH.CO.
CHS|CHICO'S FAS INC
PLCE|CHILDREN'S PLACE RETAIL STORES
CHOLY|CHINA OILFIELD SERVICES LTD
CICHY|CHINA CONSTRUCTION BANK CORPOR
CIM|CHIMERA INVESTMENT CORPORATION
CMRX|CHIMERIX, INC.
CHN|CHINA FUND INC.
CHL|CHINA MOBILE LIMITED
SNP|CHINA PETROLEUM & CHEMICAL COR
CHA|CHINA TELECOM CORP LTD
CHU|CHINA UNICOM (HONG KONG) LTD
CHDX|CHINDEX INTERNATIONAL, INC.
CHC|CHINA HYDROELECTRIC CORP
HTHT|CHINA LODGING GROUP LIMITED
CMG|CHIPOTLE MEXICAN GRILL, INC.
CHH|CHOICE HOTELS INTL INC
CQB|CHIQUITA BRANDS INTL INC.
CBK|CHRISTOPHER & BANKS CORPORATIO
CB|CHUBB CORP
CHT|CHUNGHWA TELECOM COMPANY LTD
CHD|CHURCH & DWIGHT CO., INC.
CHDN|CHURCHILL DOWNS INC
CHUY|CHUYS HLDGS INC
CBR|CIBER INC
CIOXY|CIELO S A
CIEN|CIENA CORPORATION
XEC|CIMAREX ENERGY CO
CBB|CINCINNATI BELL INC.
CINF|CINCINNATI FINANCIAL CRP
CIDM|CINEDIGM CORP
CNK|CINEMARK HOLDINGS, INC.
CIR|CIRCOR INTERNATIONAL INC
CSCO|CISCO SYSTEMS, INC.
CTAS|CINTAS CORPORATION
CZNC|CITIZENS & NORTHERN CORPORATIO
CWSB|WTS/CITIGROUP INC.
CPRC|CITIGROUP INC.
C|CITIGROUP INC.
CTRN|CITI TRENDS, INC.
CPRN|CITIGROUP CAPITAL XIII
MLPC|C-TRACKS ETNS BASED ON
CIA|CITIZENS, INC.
CTXS|CITRIX SYSTEMS INC
CHCO|CITY HOLDING CO
CYNPRC|CITY NATIONAL CORPORATION
CYN|CITY NATIONAL CORP
CLC|CLARCOR INC
CLH|CLEAN HARBORS INC
CCO|CLEAR CHANNEL OUTDOOR HOLDINGS
CLFD|CLEARFIELD INC
CLRO|CLEARONE COMMUNICATIONS, INC.
CLW|CLEARWATER PAPER CORPORATION
CLV|CLIFFS NATURAL RESOURCES INC.
CSBK|CLIFTON SVGS BANCORP INC
CLX|CLOROX CO (THE) (DELAWARE)
CLD|CLOUD PEAK ENERGY INC
GLO|CLOUGH GLBL OPPORTUNITIES FD
CLVS|CLOVIS ONCOLOGY INC
MYCC|CLUBCORP HOLDINGS, INC.
COH|COACH INC
CIE|COBALT INTERNATIONAL ENERGY
COBZ|COBIZ FINANCIAL INC
COKE|COCA COLA BOTTLING CO CONSLDTD
KO|COCA-COLA COMPANY (THE)
CCH|COCA-COLA HBC AG
CCE|COCA-COLA ENTERPRISES, INC.
KOF|COCA COLA FEMSA SA
CHEOY|COCHLEAR LIMITED
CDXS|CODEXIS INC.
CDE|COEUR MINING INC
CCOI|COGENT COMMUNICATIONS GROUP IN
CGNX|COGNEX CORP
CTSH|COGNIZANT TECHNOLOGY
COHR|COHERENT INC.
CNS|COHEN & STEERS, INC.
UTF|COHEN & STEERS INFRA FUND INC
COHU|COHU INC
CCIX|COLEMAN CABLE, INC.
CFX|COLFAX CORPORATION
CL|COLGATE-PALMOLIVE CO
CLCT|COLLECTORS UNIVERSE INC
CLNY|COLONY FINANCIAL INC.
CLNYPRA|COLONY FINANCIAL, INC.
COLB|COLUMBIA BKG SYS INC
CBRX|COLUMBIA LABS INC
COLM|COLUMBIA SPORTSWEAR COMPANY
CMCO|COLUMBUS MCKINNON CORP
FIX|COMFORT SYSTEMS USA INC
CMCSA|COMCAST CORPORATION
CMCSK|COMCAST CORPORATION
CCV|COMCAST CORPORATION
CMA|COMERICA INCORPORATED
CMAWS|WTS/COMERICA INCORPORATED
CBSH|COMMERCE BANCSHARES INC
CMC|COMMERCIAL METALS CO
CVGI|COMMERCIAL VEHICLE GROUP, INC.
CMWAY|COMMONWEALTH BANK OF AUSTRALIA
CWH|COMMONWEALTH REIT
CWHPRD|COMMONWEALTH REIT
CWHN|COMMONWEALTH REIT
CWHPRE|COMMONWEALTH REIT
CBU|COMMUNITY BANK SYSTEMS INC
CYH|COMMUNITY HEALTH SYS INC
CBNY|COMMUNITY NATL BK GREAT
JCS|COMMUNICATIONS SYSTEMS INC
CTBI|COMMUNITY TRUST BANCORP INC
CVLT|COMMVAULT SYSTEMS INC
COB|COMMUNITYONE BANCORP
CFRUY|COMPAGNIE FINANCIERE RICHEMONT
CIG|CIA ENERGETICA DE MINAS GERAIS
CBD|COMPANHIA BRASILEIRA
SBS|COMPANHIA DE SANEAMENTO BASICO
ELP|CIA PARANAENSE ENER SPON ADR P
BVN|COMPANIA DE MINAS BUENAVENTURA
CMP|COMPASS MINERALS INTL, INC.
CODI|COMPASS DIVERSIFIED HOLDINGS
CPSI|COMPUTER PROGRAMS & SYSTEMS
CSC|COMPUTER SCIENCES CORP
CSVI|COMPUTER SVCS INC
CTG|COMPUTER TASK GROUP, INC.
CPWR|COMPUWARE CORP.
CIX|COMPX INTERNATIONAL INC.
SCOR|COMSCORE, INC.
CRK|COMSTOCK RESOURCES INC(NEW)
CMTL|COMTECH TELECOMM CORP NEW
CNSI|COMVERSE, INC.
CAG|CONAGRA INC
CNW|CON-WAY INC.
CNAT|CONATUS PHARMACEUTICALS INC.
CXO|CONCHO RESOURCES INC.
CNQR|CONCUR TECHNOLOGIES INC
CCUR|CONCURRENT COMPUTER CORPORATIO
CNMD|CONMED CORP
CTWS|CONNECTICUT WATER SVC
CNOB|CONNECTONE BANCORP INC
CONN|CONNS, INC.
COP|CONOCOPHILLIPS
CNX|CONSOL ENERGY INC.
CNSL|CONSOLIDATED COMMUNICATIONS IL
ED|CONSOLIDATED EDISON INC
CGX|CONSOLIDATED GRAPHICS INC
CTO|CONSOLIDATED-TOMOKA LAND CO
CTCT|CONSTANT CONTACT INC
STZ|CONSTELLATION BRANDS INC
CEP|CONSTELLATION ENERGY PARTNERS
CPSS|CONSUMER PORTFOLIO SVCS INC
MCF|CONTANGO OIL & GAS COMPANY
CLR|CONTINENTAL RESOURCES, INC
VLRS|CONTROLADORA VUELA COMPANIA DE
CVG|CONVERGYS CORPORATION
COO|COOPER COMPANIES INC (NEW)
CTB|COOPER TIRE & RUBBER CO.
CPRT|COPART INC
CORT|CORCEPT THERAPEUTICS INC
CORE|CORE MARK HLDG CO INC
CMT|CORE MOLDING TECHNOLOGIES INC
COR|CORESITE REALTY CORP
CORPRA|CORESITE REALTY CORP
CORR|CORENERGY INFRASTRUCTURE
CLGX|CORELOGIC INC
COCO|CORINTHIAN COLLEGES INC
CRTX|CORNERSTONE THERAPEUTICS INC.
CSOD|CORNERSTONE ONDEMAND INC.
GLW|CORNING INCORPORATED
CEB|THE CORP EXECUTIVE BOARD CO.
OFC|CORPORATE OFFICE PROPERTIES
OFCPRL|CORPORATE OFFICE PROPERTIES TR
CXW|CORRECTIONS CORP OF AMERICA
CRVL|CORVEL CORP
ATX|COSTA INC
COST|COSTCO WHOLESALE CORPORATION
CSGP|COSTAR GROUP INC
COT|COTT CORP.
COTY|COTY, INC.
CFCPRB|COUNTRYWIDE CAPITAL V
CFCPRA|COUNTRYWIDE CAPITAL IV 6.75%
CRRC|COURIER CORP
CUZ|COUSINS PPTYS INC
CVD|COVANCE INC
CVA|COVANTA HOLDING CORP
CVTI|COVENANT TRANSPORTATION
COVS|COVISINT CORPORATION
COWN|COWEN GROUP, INC.
CBRL|CRACKER BARREL OLD COUNTRY STO
BREW|CRAFT BREW ALLIANCE, INC
CR|CRANE CO (DELAWARE)
CRDB|CRAWFORD & CO CLASS-B
CRDA|CRAWFORD & CO CL-A
CRAY|CRAY INC
CACC|CREDIT ACCEPTANCE CORPORATION
CS|CREDIT SUISSE GROUP SPON ADR
CREE|CREE, INC.
CEQP|CRESTWOOD EQUITY PARTNERS LP
CMLP|CRESTWOOD MIDSTREAM PARTNERS L
CRESY|CRESUD S.A. SPONS ADR
CWGL|CRIMSON WINE GROUP, LTD
CROX|CROCS, INC.
CCRN|CROSS CTRY HEALTHCARE INC
XTEX|CROSSTEX ENERGY LP
XTXI|CROSSTEX ENERGY, INC.
CCI|CROWN CASTLE INTL CORP
CRWS|CROWN CRAFTS INC
CCK|CROWN HOLDINGS INC
CRWN|CROWN MEDIA HLDGS INC
CRY|CRYOLIFE INC
CTRP|CTRIP.COM INTERNATIONAL, LTD.
CTP|CTPARTNERS EXECUTIVE SEARCH IN
CUBE|CUBESMART
CUBEPRA|CUBESMART
CUB|CUBIC CORP (DELAWARE)
CBST|CUBIST PHARMACEUTICALS, INC.
CFR|CULLEN FROST BANKERS INC
CFI|CULP INC
CPIX|CUMBERLAND PHARMACEUTICALS INC
CMI|CUMMINS INC
CMLS|CUMULUS MEDIA INC
CRIS|CURIS INC
CW|CURTISS-WRIGHT CORP
CUBI|CUSTOMERS BANCORP INC
CUTR|CUTERA INC
CVT|CVENT, INC.
CYBE|CYBEROPTICS CORP
CYBX|CYBERONICS INC
CYNO|CYNOSURE INC
CY|CYPRESS SEMICONDUCTOR CORPORAT
CYT|CYTEC INDS INC
CYTK|CYTOKINETICS INC
CONE|CYRUSONE INC
DBSDY|DBS GROUP HOLDINGS
DPM|DCP MIDSTREAM PARTNERS LP
DCT|DCT INDUSTRIAL TRUST INC.
DDR|DDR CORP
DDRPRH|DDR CORP.
DDRPRJ|DDR CORP.
DDRPRK|DDR CORP.
DLLR|DFC GLOBAL CORP
DHI|D.R. HORTON, INC.
DST|DST SYSTEM INC
DSPG|DSP GROUP INC
DTE|DTE ENERGY COMPANY
DTZ|DTE ENERGY COMPANY
DSW|DSW INC.
DTSI|DTS, INC.
DXPE|DXP ENTERPRISES INC
DDAIY|DAIMLER AG
DJCO|DAILY JOURNAL CORP
DWAHY|DAIWA HOUSE IND LTD (ADR)
DAKT|DAKTRONICS INC
DAN|DANA HOLDING CORPORATION
DHR|DANAHER CORPORATION
DANOY|DANONE
DRI|DARDEN RESTAURANTS INC
DAR|DARLING INTERNATIONAL INC
DWCH|DATAWATCH CORP
DTLK|DATALINK CORP
DVA|DAVITA HEALTHCARE PARTNERS INC
DWSN|DAWSON GEOPHYSICAL CO.
DXR|DAXOR CORP
TRAK|DEALERTRACK TECHNOLOGIES, INC.
DF|DEANS FOODS CO
DE|DEERE & COMPANY
DFRG|DEL FRISCOS RESTAURANT GROUP
DK|DELEK US HLDGS INC
DKL|DELEK LOGISTICS PARTNERS, LP
DAL|DELTA AIR LINES, INC.
DLA|DELTA APPAREL INC
DGAS|DELTA NATURAL GAS CO INC
DEL|DELTIC TIMBER CORP
DNR|DENBURY RESOURCES INC
DLX|DELUXE CORP
DMD|DEMAND MEDIA, INC.
DWRE|DEMANDWARE INC.
DNY|DENALI FUND/THE
DNN|DENISON MINES CORP.
DENN|DENNY'S CORPORATION
XRAY|DENTSPLY INTL INC
DSCI|DERMA SCIENCES INC
DSGX|DESCARTES SYSTEMS GRP (THE)
DEPO|DEPOMED, INC
DEST|DESTINATION MATERNITY CORPORAT
DXLG|DESTINATION XL GROUP, INC.
DXB|DEUTSCHE BK CNTG CAP TR II
DTT|DEUTSCHE BK CAP FUND IX
DTK|DEUTSCHE BK CONTINGENT
DTEGY|DEUTSCHE TELEKOM AG
DVN|DEVON ENERGY CORPORATION (NEW)
DV|DEVRY EDUCATION GROUP INC.
DXCM|DEXCOM, INC.
DEO|DIAGEO PLC SPON ADR (NEW)
DMND|DIAMOND FOODS, INC.
DHIL|DIAMOND HILL INVESTMENT GROUP
DO|DIAMOND OFFSHORE DRILLING, INC
DRII|DIAMOND RESORTS INTL INC
DRH|DIAMONDROCK HOSPITALITY CO
FANG|DIAMONDBACK ENERGY INC
DHX|DICE HOLDINGS, INC.
DKS|DICKS SPORTING GOODS INC
DBD|DIEBOLD INCORPORATED
DGII|DIGI INTERNATIONAL, INC.
DMRC|DIGIMARC CORPORATION
DRAD|DIGIRAD CORPORATION
DLRPRE|DIGITAL REALTY TRUST, INC.
DLRPRG|DIGITAL REALTY TRUST, INC.
DRIV|DIGITAL RIVER INC
DGI|DIGITALGLOBE, INC.
DCOM|DIME COMMUNITY BANCSHARES
DGIT|DIGITAL GENERATION INC
DDS|DILLARDS INC CL-A
DIN|DINEEQUITY, INC.
DIOD|DIODES INC
DIS|WALT DISNEY COMPANY (THE)
DFS|DISCOVER FINANCIAL SERVICES
DFSPRB|DISCOVER FINANCIAL SERVICES
DISCA|DISCOVERY COMMUNICATIONS, INC.
DISCK|DISCOVERY COMMUNICATIONS, INC.
DISH|DISH NETWORK CORPORATION
DTV|DIRECTV
BAGR|DIVERSIFIED RESTAURANT HOLDING
DXYN|DIXIE GROUP INC
DM|DOLAN MEDIA COMPANY
DLB|DOLBY LABORATORIES, INC.
DG|DOLLAR GENERAL CORPORATION
DLTR|DOLLAR TREE INC.
DDC|DOMINION DIAMOND CORP
D|DOMINION RESOURCES, INC.
DRU|DOMINION RESOURCES, INC.
DCUA|DOMINION RESOURCES, INC.
DCUB|DOMINION RESOURCES, INC.
DPZ|DOMINO'S PIZZA, INC.
UFS|DOMTAR CORPORATION
DCI|DONALDSON CO INC
DGICA|DONEGAL GROUP INC
RRD|R R DONNELLEY & SONS CO
DRL|DORAL FINL CORP
DIIBF|DOREL INDUSTRIES INC
DORM|DORMAN PRODUCTS INC
HILL|DOT HILL SYSTEMS CORP
DBLE|DOUBLE EAGLE PETROLEUM CO
DEI|DOUGLAS EMMETT INC.
PLOW|DOUGLAS DYNAMICS INC
DOV|DOVER CORPORATION
DDE|DOVER DOWNS GAMING & ENTMT INC
DVD|DOVER MOTORSPORTS INC
DOW|DOW CHEMICAL CO
DPS|DR PEPPER SNAPPLE GROUP, INC.
DWA|DREAMWORKS ANIMATION SKG, INC.
DRC|DRESSER-RAND GROUP INC.
DW|DREW INDUSTRIES INC NEW
DRQ|DRIL-QUIP, INC.
DD|E.I. DU PONT DE NEMOURS AND CO
DCO|DUCOMMUN INC DEL
DRE|DUKE REALTY CORP
DUK|DUKE ENERGY CORPORATION
DUKH|DUKE ENERGY CORPORATION
DNB|DUN & BRADSTREET CORP DEL NEW
DDEJF|DUNDEE CORPORATION - SUB VTG
DNKN|DUNKIN BRANDS GROUP INC
DFT|DUPONT FABROS TECHNOLOGY INC.
DFTPRA|DUPONT FABROS TECHNOLOGY INC.
DFTPRB|DUPONT FABROS TECHNOLOGY INC.
DRTX|DURATA THERAPEUTICS INC
DRRX|DURECT CORP
DYAX|DYAX CORP
DY|DYCOM INDUSTRIES INC
BOOM|DYNAMIC MATERIALS CORP
DRCO|DYNAMICS RESEARCH CORP
DVAX|DYNAVAX TECHNOLOGIES CORP
DX|DYNEX CAPITAL INC
DYN|DYNEGY INC NEW DEL
EMC|EMC CORPORATION MASS
EMCI|EMC INS GROUP INC
E|ENI S.P.A SPON ADR
EOG|EOG RESOURCES INC
EPIQ|EPIQ SYS INC
EPL|EPL OIL AND GAS INC
ESBF|ESB FINANCIAL CORP
EQT|EQT CORPORATION
EPR|EPR PROPERTIES
EPRPRC|ENTERTAINMENT PROPERTIES TRUST
EPRPRE|EPR PROPERTIES
EPRPRF|EPR PROPERTIES
EQM|EQT MIDSTREAM PARTNERS LP
ERA|ERA GROUP INC.
ETFC|E*TRADE FINANCIAL CORPORATION
EVEP|EV ENERGY PARTNERS LP
EXP|EAGLE MATERIALS INC.
ELNK|EARTHLINK, INC.
EWBC|EAST WEST BANCORP INC
EML|EASTERN COMPANY
EIHI|EASTERN INS HLDGS INC
EVBS|EASTERN VA BANKSHARES INC
EGP|EASTGROUP PROPERTIES INC
EMN|EASTMAN CHEM CO
EV|EATON VANCE CORP (NON-VTG)
ETY|EATON VANCE TAX-MANAGED
ETW|EATON VANCE
EXG|EATON VANCE TAX-MANAGED GLOBAL
EBAY|EBAY INC.
ELON|ECHELON CORP
ECHO|ECHO GLOBAL LOGISTICS INC.
SATS|ECHOSTAR CORPORATION
ECL|ECOLAB INC
EEI|ECOLOGY & ENVIRONMENT INC CL A
EDG|EDGEN GROUP INC
EDGW|EDGEWATER TECHNOLOGY INC
EIX|EDISON INTERNATIONAL
EDR|EDUCATION REALTY TRUST, INC.
EVAC|EDWARDS GROUP LIMITED
EW|EDWARDS LIFESCIENCES CORP
EGAN|EGAIN CORP.
EHTH|EHEALTH, INC.
BAGL|EINSTEIN NOAH RESTAURANT GROUP
EGHT|8X8 INC
EE|EL PASO ELECTRIC (NEW)
EPPRC|EL PASO ENERGY CAPITAL TR I
EPB|EL PASO PIPELINE PARTNERS, L.P
ELN|ELAN CORP PLC (ADR)
EGO|ELDORADO GOLD CORP (NEW)
ECIFY|ELECTRICITE DE FRANCE SA
ELRC|ELECTRO RENT CORP
ESIO|ELECTRO SCIENTIFIC INDS INC
EA|ELECTRONIC ARTS
EFII|ELECTRONICS FOR IMAGING INC.
RDEN|ELIZABETH ARDEN INC
EFC|ELLINGTON FINANCIAL LLC
EARN|ELLINGTON RESIDENTIAL MORT REI
PERY|PERRY ELLIS INTERNATIONAL
LONG|ELONG, INC.
EMAN|EMAGIN CORP
AKOB|EMBOTELLADORA ANDINA SA
ERJ|EMBRAER SA
EMKR|EMCORE CORP
EME|EMCOR GROUP INC.
EBS|EMERGENT BIOSOLUTIONS INC
ESC|EMERITUS CORPORATION
EMR|EMERSON ELECTRIC CO.
EOX|EMERALD OIL INC
EMES|EMERGE ENERGY SVCS LP
MSN|EMERSON RADIO CORP
EMMS|EMMIS COMMUNICATIONS CORP
EDE|EMPIRE DISTRICT ELEC CO
ESRT|EMPIRE STATE REALTY TRUST,INC.
EIG|EMPLOYERS HOLDINGS INC.
EOC|EMPRESA NACIONAL DE ELECTRCDAD
ELX|EMULEX CORP.
ECA|ENCANA CORPORATION
ENB|ENBRIDGE INC.
EEQ|ENBRIDGE ENERGY MGMT, LLC
ENTA|ENANTA PHARMACEUTICALS INC
ECPG|ENCORE CAPITAL GROUP INC
WIRE|ENCORE WIRE CORP
EXK|ENDEAVOUR SILVER CORP.
EGN|ENERGEN CORP
ENLAY|ENEL SOCIETA PER AZIONI
ENR|ENERGIZER HOLDINGS, INC.
ELGX|ENDOLOGIX INC
ECYT|ENDOCYTE, INC.
ERII|ENERGY RECOVERY INC
ETP|ENERGY TRANSFER PARTNERS, L.P.
ENI|ENERSIS S.A. - SPON ADR
ENS|ENERSYS
ENOC|ENERNOC, INC.
ERF|ENERPLUS RESOURCES FUND
EGL|ENGILITY HLDGS INC
ENG|ENGLOBAL CORPORATION
EBF|ENNIS INC
NPO|ENPRO INDUSTRIES, INC.
ENSG|THE ENSIGN GROUP INC.
ENTG|ENTEGRIS, INC.
ETM|ENTERCOM COMMS. CORP
EAA|ENTERGY ARKANSAS CAPITAL I
ETR|ENTERGY CORPORATION
ELJ|ENTERGY LOUISIANA LLC
EBTC|ENTERPRISE BANCORP INC, MA
EFSC|ENTERPRISE FINL SVCS CORP.
EPD|ENTERPRISE PRODUCTS PART L.P
EVC|ENTRAVISION COMMUNICATIONS CP
ENTR|ENTROPIC COMMUNICATIONS, INC.
ENZN|ENZON PHARMACEUTICALS INC
EQU|EQUAL ENERGY LTD
ENV|ENVESTNET, INC.
ENZ|ENZO BIOCHEM INC
EVHC|ENVISION HEALTHCARE HOLDINGS,
EPAM|EPAM SYS INC
PLUS|EPLUS INC
EFX|EQUIFAX INC
EQIX|EQUINIX INC
ELS|EQUITY LIFESTYLE PROPERTIES, I
EQY|EQUITY ONE INC
EQR|EQUITY RESIDENTIAL
ERIC|ERICSSON AMERICAN
ERIE|ERIE INDEMNITY COMPANY CL-A
ESCA|ESCALADE INC.
ESE|ESCO TECHNOLOGIES INC
ESPR|ESPERION THERAPEUTICS INC
ESP|ESPEY MFG.&ELECTRONICS
ESSA|ESSA BANCORP, INC.
ESS|ESSEX PROPERTY TRUST INC
ESL|ESTERLINE TECHNOLOGIES CORP.
DEG|DELHAIZE GROUP
ETH|ETHAN ALLEN INTERIORS, INC
EOPN|E2OPEN INC
EEFT|EURONET WORLDWIDE INC
EADSY|EUROPEAN AERONAUTIC DEFENCE AN
EVR|EVERCORE PARTNERS, INC.
EVER|EVERBANK FINANCIAL CORP
EVTC|EVERTEC INC
EVRY|EVRYWARE GLOBAL INC
EPM|EVOLUTION PETROLEUM CORPORATIO
EVOL|EVOLVING SYSTEMS INC
EXA|EXA CORPORATION
EXAS|EXACT SCIENCES CORP
EXAR|EXAR CORPORATION
EXAC|EXACTECH INC
EXAM|EXAMWORKS GROUP, INC.
EXL|EXCEL TRUST INC.
EXC|EXELON CORPORATION
EXEL|EXELIXIS, INC.
XLS|EXELIS INC.
EXLS|EXLSERVICE HOLDINGS, INC.
EXPE|EXPEDIA, INC.
EXPD|EXPEDITORS INTL WASH INC
EXPO|EXPONENT, INC.
EXPGY|EXPERIAN PLC
EXPR|EXPRESS, INC.
ESRX|EXPRESS SCRIPTS HOLDINGS
EXLP|EXTERRAN PARTNERS L.P.
EXR|EXTRA SPACE STORAGE INC.
EXH|EXTERRAN HOLDINGS, INC.
EXTR|EXTREME NETWORKS INC
EZPW|E Z CORP INC CL-A NON VTG
XOM|EXXON MOBIL CORPORATION
FFG|FBL FINL GROUP INC CL A
FEIC|FEI COMPANY
FLIR|FLIR SYSTEMS INC
FBRC|FBR & CO
FMC|FMC CORPORATION
FTI|FMC TECHNOLOGIES INC
FNB|FNB CORPORATION (VA)
FXCM|FXCM INC.
FXEN|FX ENERGY, INC.
FTD|FTD COMPANIES, INC.
FCN|FTI CONSULTING, INC.
FB|FACEBOOK, INC.
FDS|FACTSET RESEARCH SYSTEMS INC
FICO|FAIR ISAAC INC
FCS|FAIRCHILD SEMICON INTL
FRP|FAIRPOINT COMMUNICATIONS, INC.
FALC|FALCONSTOR SOFTWARE INC
FDO|FAMILY DOLLAR STORES INC
DAVE|FAMOUS DAVE'S OF AMERICA
FANUY|FANUC CORP
FARM|FARMERS BROTHERS CO
FFKT|FARMERS CAPITAL BANK CORP
FARO|FARO TECHNOLOGIES INC
FAST|FASTENAL CO
AGM|FEDERAL AGRICULTURAL MORTGAGE
FDML|FEDERAL MOGUL CORP
FRT|FEDERAL RLTY INVT TR SBI
FSS|FEDERAL SIGNAL CORP
FII|FEDERATED INVESTORS, INC.
FNHC|FEDERATED NATL HLDG CO
FDX|FEDEX CORP
FCH|FELCOR LODGING TRUST INC
FHCO|FEMALE HEALTH COMPANY
FOE|FERRO CORPORATION
FFIV|F5 NETWORKS INC
FCSC|FIBROCELL SCIENCE, INC.
FIS|FIDELITY NATL INFO SVCS INC
FNF|FIDELITY NATIONAL FINL
FRGI|FIESTA RESTAURANT GROUP, INC.
FNP|FIFTH & PACIFIC COMPANIES INC
FITB|FIFTH THIRD BANCORP
FSC|FIFTH STREET FINANCE CORP
JOBS|51JOB, INC.
FNGN|FINANCIAL ENGINES, INC.
FISI|FINANCIAL INSTITUTIONS INC
FNSR|FINISAR CORPORATION
FINL|FINISH LINE INC CL-A
FEYE|FIREEYE, INC.
FAC|FIRST ACCEPTANCE CORP
FAF|FIRST AMERICAN FIN CORP
FNLC|FIRST BANCORP, INC (ME)
FBP|FIRST BANCORP (PUERTO RICO)
FBNC|FIRST BANCORP
BUSE|FIRST BUSEY CORP
FCFS|FIRST CASH FINANCIAL SERVICE
FCNCA|FIRST CITIZENS BANKSHARES CL A
FCF|FIRST COMWLTH FINL CORP PA
FCBC|FIRST COMMUNITY BANCSHARES INC
FBNK|FIRST CONN BANCORP INC MD
FDEF|FIRST DEFIANCE FINANCIAL CORP.
FFBC|FIRST FINL BANCORP
FFBH|FIRST FED BANCSHARES ARK INC
FFIN|FIRST FINL BANKSHARES INC
THFF|FIRST FINANCIAL CORP INDIANA
FFNW|FIRST FINANCIAL NORTHWEST INC
SCBT|FIRST FINANCIAL HOLDINGS INC
FHN|FIRST HORIZON NATIONAL CORP
FR|FIRST INDUSTRIAL REALTY TRUST
FIBK|FIRST INTST BANCSYSTEM INC
FLIC|FIRST OF LONG ISLAND CORP
AG|FIRST MAJESTIC SILVER CORP
FRME|FIRST MERCHANTS CORPORATION
FMBI|FIRST MIDWEST BANCORP INC DEL
NBCB|FIRST NBC BK HLDG CO
FNFG|FIRST NIAGARA FINANCIAL GROUP,
FPO|FIRST POTOMAC REALTY TRUST
FPOPRA|FIRST POTOMAC REALTY TRUST
FRC|FIRST REPUBLIC BANK
FSBK|FIRST SOUTH BANCORP INC. /VA
SRCE|FIRST SOURCE CORPORATION
FHY|FIRST TRUST STRATEGIC HIGH
FUBC|1ST UNITED BANCORP, INC.
FUNC|FIRST UNITED CORP
FSRV|FIRSTSERVICE CORP
FISV|FISERV INC
FMER|FIRSTMERIT CORP
FMERPRA|FIRSTMERIT CORPORATION
FBC|FLAGSTAR BANCORP, INC.
FE|FIRSTENERGY CORP
FIVE|FIVE BELOW INC
FPRX|FIVE PRIME THERAPEUTICS, INC.
FVE|FIVE STAR QUALITY CARE INC
FLML|FLAMEL TECHNOLOGIES SPON ADR
FLT|FLEETCOR TECHNOLOGIES, INC.
FLXS|FLEXSTEEL INDUSTRIES INC
FTK|FLOTEK INDUSTRIES, INC.
FLR|FLUOR CORPORATION
FLOW|FLOW INTERNATIONAL CORP
FLO|FLOWERS FOODS INC
FLS|FLOWSERVE CORPORATION
FLDM|FLUIDIGM CORP
FFIC|FLUSHING FINANCIAL CORPORATION
FLY|FLY LEASING LTD
FMX|FOMENTO ECONOMICO MEXICANO
FL|FOOT LOCKER, INC.
FES|FORBES ENERGY SERVICES LTD
F|FORD MOTOR COMPANY
FCEA|FOREST CITY ENTERPRISES (CL-A)
FRX|FOREST LABORATORIES INC
FST|FOREST OIL CORPORATION
FOR|FORESTAR REAL ESTATE GROUP INC
FORM|FORMFACTOR INC
FORR|FORRESTER RESEARCH INC.
FRF|FORTEGRA FINANCIAL CORPORATION
FTNT|FORTINET, INC.
FBHS|FORTUNE BRANDS HOME & SECURITY
FET|FORUM ENERGY TECHNOLOGIES INC
FWRD|FORWARD AIR CORPORATION
FOSL|FOSSIL GROUP INC.
FSM|FORTUNA SILVER MINES INC.
FSTR|FOSTER L.B. CL A
FXCB|FOX CHASE BANCORP, INC.
FOXF|FOX FACTORY HOLDING CORP.
FRAN|FRANCESCA'S HOLDINGS CORP
FNV|FRANCO-NEVADA CORPORATION
FC|FRANKLIN COVEY CO
FELE|FRANKLIN ELECTRIC INC
FRNK|FRANKLIN FINANCIAL CORPORATION
BEN|FRANKLIN RESOURCES INC
FSP|FRANKLIN STREET PROPERTIES
FRED|FREDS INC CL A
FCX|FREEPORT-MCMORAN COPPER & GOLD
RAIL|FREIGHTCAR AMERICA, INC.
FEIM|FREQUENCY ELECTRONIC INC
FMS|FRESENIUS MEDICAL CARE AG & CO
TFM|THE FRESH MARKET, INC.
FRD|FRIEDMAN INDS INC
FRS|FRISCH'S RESTAURANTS INC
FTR|FRONTIER COMMUNICATIONS
FTEK|FUEL TECH INC
FSYS|FUEL SYSTEMS SOLUTIONS INC
FLL|FULL HOUSE RESORTS
FUL|H.B. FULLER COMPANY
FULT|FULTON FINANCIAL CORPORATION
FURX|FURIEX PHARMACEUTICAL, INC.
FRM|FURMANITE CORPORATION
FF|FUTUREFUEL CORP.
GK|G & K SERVICES INC (CL-A)
GBL|GAMCO INVESTORS INC
GMT|GATX CORPORATION
GEAGY|GEA GROUP AG
GEO|GEO GROUP INC
GDFZY|GDF SUEZ
GFIG|GFI GROUP INC.
ALLYPRA|ALLY FINANCIAL INC.
GSIG|GSI GROUP INC
GNC|GNC HOLDINGS INC.
GPX|GP STRATEGIES CORP
GIII|G-III APPAREL GROUP, LTD.
GABPRG|GABELLI EQUITY TRUST INC
GSIT|GSI TECHNOLOGY INC
GLUPRA|THE GABELLI GLOBAL UTILITY
GAIA|GAIAM INC
GCAP|GAIN CAPITAL HOLDINGS, INC.
AJG|ARTHUR J GALLAGHER & CO
GGN|GAMCO GLOBAL GOLD, NATURAL
GGNPRB|GABELLI GLOBAL GOLD, NAT RES
GPIC|GAMING PARTNERS INTL CORP
GLPI|GAMING AND LEISURE PROP, INC.
GME|GAMESTOP CORP
GCI|GANNETT CO.INC.
GPS|GAP INC
IT|GARTNER, INC.
GST|GASTAR EXPLORATION INC
OGZPY|GAZPROM ADR
GKNT|GEEKNET INC
GY|GENCORP INC
GNRC|GENERAC HOLDINGS INC.
BGC|GENERAL CABLE CORP
GNCMA|GENERAL COMMUNICATION INC CL A
GD|GENERAL DYNAMICS CORP.
GE|GENERAL ELECTRIC CO
GEK|GENERAL ELEC CAP CORP
GEB|GENERAL ELECTRIC CAPITAL CORP
GGP|GENERAL GROWTH PROPERTIES INC
GGPPRA|GGP, INC.
GIS|GENERAL MILLS INC
GMO|GENERAL MOLY, INC.
GM|GENERAL MOTORS COMPANY
GMWSA|WTS/GENERAL MOTORS COMPANY
GMWSB|WTS/GENERAL MOTORS COMPANY
GMWSC|WTS GENERAL MOTORS COMPANY
GCO|GENESCO INC.
GWR|GENESEE & WYOMING INC
GWRU|GENESEE & WYOMING INC.
GNTX|GENTEX CORP
GEL|GENESIS ENERGY, L.P.
GNE|GENIE ENERGY LTD
GNMK|GENMARK DIAGNOSTICS INC
GHDX|GENOMIC HEALTH, INC.
GPC|GENUINE PARTS CO.
GTIV|GENTIVA HEALTH SERVICES INC
GNW|GENWORTH FINANCIAL INC
THRM|GENTHERM INCORPORATED
GEOS|GEOSPACE TECHNOLOGIES CORP
GGB|GERDAU SA SPON ADR
GABC|GERMAN AMERICAN BANCORP, INC.
GTY|GETTY REALTY CORP (NEW)
GFSZY|G4S PLC
GA|GIANT INTERACTIVE GROUP INC.
ROCK|GIBRALTAR INDUSTRIES INC
GIMO|GIGAMON INC
GILD|GILEAD SCIENCES
GIL|GILDAN ACTIVEWEAR INC
GBCI|GLACIER BANCORP INC (NEW)
GLAD|GLADSTONE CAPITAL CORPORATION
GOOD|GLADSTONE COMMERCIAL CORP
GAIN|GLADSTONE INVESTMENT CORP
LAND|GLADSTONE LD CORP
GLT|GLATFELTER
GSK|GLAXOSMITHKLINE PLC
GLCH|GLEACHER & CO INC
GLNIF|GLENTEL INC
GCA|GLOBAL CASH ACCESS HLDGS, INC.
GRT|GLIMCHER REALTY TRUST SBI
GRTPRI|GLIMCHER REALTY TRUST
GPN|GLOBAL PMTS INC
GLPW|GLOBAL POWER EQUIPMENT GRP INC
GGS|GLOBAL GEOPHYSICAL SERVICES IN
ENT|GLOBAL EAGLE ENTERTAINMENT INC
BRSS|GLOBAL BRASS AND COPPER HOLDIN
GSM|GLOBE SPECIALTY METALS INC
GCOM|GLOBECOMM SYSTEMS INC
GMED|GLOBUS MEDICAL INC
GFI|GOLD FIELDS LTD
GORO|GOLD RESOURCE CORPORATION
GG|GOLDCORP INC
GS|GOLDMAN SACHS GROUP, INC.(THE)
GSPRA|GOLDMAN SACHS GROUP INC
GSPRB|(GS) GOLDMAN SACHS GROUP, INC
GSPRI|THE GOLDMAN SACHS GROUP INC
GSPRJ|THE GOLDMAN SACHS GROUP, INC
GSF|GOLDMAN SACHS GROUP, INC
GBDC|GOLUB CAPITAL BDC LLC
GDP|GOODRICH PETROLEUM CORP (NEW)
GT|THE GOODYEAR TIRE & RUBBER CO.
GTPPP|GOODYEAR TIRE & RUBBER CO
GOOG|GOOGLE, INC.
GMAN|GORDMANS STORES, INC.
GRC|GORMAN-RUPP CO
GOV|GOVT PROPERTIES INCOME TRUST
GRA|W.R. GRACE & CO (NEW)
GGG|GRACO INC
GTI|GRAFTECH INTERNATIONAL LTD
GHM|GRAHAM CORP (DEL)
GWW|W.W. GRAINGER INCORPORATED
GPT|GRAMERCY PROPERTY TRUST INC
GTE|GRAN TIERRA ENERGY INC
LOPE|GRAND CANYON EDUCATION, INC.
GVA|GRANITE CONSTRUCTION INC.
GRPU|GRANITE REAL ESTATE INVESTMENT
GPK|GRAPHIC PACKAGING HLDGCO
GTN|GRAY TELEVISION INC
GLDD|GREAT LAKES DREDGE & DOCK CORP
GSBC|GREAT SOUTHERN BANCORP
GPL|GREAT PANTHER SILVER LTD
GXP|GREAT PLAINS ENERGY INC.
GB|GREATBATCH INC
GDOT|GREEN DOT CORPORATION
GMCR|GREEN MNTN COFFEE ROASTERS INC
GPRE|GREEN PLAINS RENEWABLE ENERGY
GBX|GREENBRIER COMPANIES INC
GHL|GREENHILL & CO.
GEF|GREIF INC
GRIF|GRIFFIN LAND & NURSERIES
GFF|GRIFFON CORPORATION
GRFS|GRIFOLS S A
GPI|GROUP 1 AUTOMOTIVE, INC.
GIB|CGI GROUP INC
GRPN|GROUPON INC
SIM|GRUPO SIMEC, S.A.B. DE C.V.
TV|GRUPO TELEVISA, S.A. GDS
PAC|GRUPO AEROPORTUARIO DEL PACIF
ASR|GRUPO AEROPORTUARIO DEL SUR
BSMX|GRUPO FINANCIERO SANTANDER MEX
GSH|GUANGSHEN RAILWAY COMPANY LTD
GBNK|GUARANTY BANCORP DEL
GES|GUESS ?, INC.
GUID|GUIDANCE SOFTWARE INC.
GWRE|GUIDEWIRE SOFTWARE INC
GULTU|GULF COAST ULTRA DEEP ROYALTY
GIFI|GULF ISLAND FABRICATION INC
GLF|GULFMARK OFFSHORE INC.
GPOR|GULFPORT ENERGY CORP (NEW)
GYRO|GYRODYNE CO AMER
HEES|H&E EQUIPMENT SERVICES INC
HCA|HCA HOLDINGS, INC.
HCC|HCC INSURANCE HOLDINGS INC
HCP|HCP, INC.
HDB|HDFC BANK LIMITED
HCI|HCI GROUP, INC.
HDS|HD SUPPLY HOLDINGS, INC.
HFFC|H F FINANCIAL CORP
HF|HFF, INC.
HTWO|HF2 FINL MGMT INC
HLUYY|H. LUNDBECK A/S
HNI|HNI CORP
HMSY|HMSC HOLDINGS CORP.
HSEA|HSBC HOLDINGS PLC
HSEB|HSBC HOLDINGS PLC
HUSIPRZ|HSBC USA INC
HUSIPRF|HSBC USA INC.
HUSIPRH|HSBC USA INC.
HSFCPRB|HSBC FINANCE CORPORATION
HSNI|HSN, INC.
HAE|HAEMONETICS CORP
HAIN|HAIN CELESTIAL GROUP INC
HAL|HALLIBURTON COMPANY
HALL|HALLMARK FINL SERVICES, INC.
HALO|HALOZYME THERAPEUTICS, INC.
HBHC|HANCOCK HOLDING CO
HNH|HANDY & HARMAN HOLDINGS LTD
HBI|HANESBRANDS INC.
HGR|HANGER INC
HAFC|HANMI FINANCIAL CORPORATION
HASI|HANNON ARMSTRONG SUSTAINABLE I
THG|HANOVER INSURANCE GROUP INC
HNSN|HANSEN MEDICAL, INC.
HSOL|HANWHA SOLARONE CO LTD
HRG|HARBINGER GROUP INC
HDNG|HARDINGE INC.
HOG|HARLEY-DAVIDSON INC
HAR|HARMAN INTL INDS INC (NEW)
HLIT|HARMONIC INC
HMY|HARMONY GOLD MNG LTD (NEW)
TINY|HARRIS & HARRIS GROUP INC.
HRS|HARRIS CORP
HPOL|HARRIS INTERACTIVE INC
HTSI|HARRIS TEETER SUPERMARKETS INC
HSC|HARSCO CORPORATION
HHS|HARTE-HANKS COMMUNICATIONS,INC
HIG|HARTFORD FINANCIAL SRVCS GROUP
HIGWS|WTS/THE HARTFORD FINANCIAL SER
HGH|THE HARTFORD FINANCIAL
HBIO|HARVARD BIOSCIENCE INC
HART|HARVARD APPARATUS REGENERATIVE
HAS|HASBRO, INC.
HAST|HASTINGS ENTERTAINMENT INC
HTS|HATTERAS FINANCIAL CORP.
HTSPRA|HATTERAS FINANCIAL CORP.
HVT|HAVERTY FURNITURE COS INC
HVTA|HAVERTY FUR COS CL-A
HE|HAWAIIAN ELEC INDS INC
HCOM|HAWAIIAN TELCOM HOLDCO, INC.
HWKN|HAWKINS INC
HAYN|HAYNES INTERNATIONAL, INC.
HCSG|HEALTHCARE SVCS GROUP INC
HLS|HEALTHSOUTH CORPORATION
HMA|HEALTH MANAGEMENT ASSOC. CL A
HR|HEALTHCARE REALTY TRUST INC
HW|HEADWATERS INC
HCN|HEALTH CARE REIT INC (DEL)
HCNPRI|HEALTH CARE REIT, INC.
HCNPRJ|HEALTH CARE REIT, INC.
HNT|HEALTH NET, INC.
HSTM|HEALTHSTREAM INC
HWAY|HEALTHWAYS INC.
HIIQ|HEALTH INS INNOVATIONS INC
HTA|HEALTHCARE TR OF AMER INC
HTLD|HEARTLAND EXPRESS INC
HTLF|HEARTLAND FINL USA INC
HPY|HEARTLAND PAYMENT SYSTEMS, INC
HTWR|HEARTWARE INTERNATIONAL INC
HL|HECLA MINING CO.
HEI|HEICO CORPORATION (NEW)
HEIA|HEICO CORP CL-A
HSII|HEIDRICK & STRUGGLES INC.
HEINY|HEINEKEN N.V.
HLX|HELIX ENERGY SOLUTNS GROUP INC
HP|HELMERICH & PAYNE INC.
HENKY|HENKEL AG AND CO. KGAA
HENOY|HENKEL AG AND CO. KGAA
JKHY|JACK HENRY & ASSOC INC
HTBK|HERITAGE COMMERCE CORP
HERO|HERCULES OFFSHORE INC
HTGC|HERCULES TECH GR CAP INC.
HFWA|HERITAGE FINANCIAL CORP
HCCI|HERITAGE-CRYSTAL CLEAN, INC.
HBOS|HERITAGE FINANCIAL GROUP
HT|HERSHA HOSPITALITY TRUST
HTPRB|HERSHA HOSPITALITY TRUST
HSY|THE HERSHEY COMPANY
HTZ|HERTZ GLOBAL HOLDINGS, INC.
HES|HESS CORPORATION
HPQ|HEWLETT-PACKARD CO.
HXL|HEXCEL CORPORATION (NEW)
HGG|HHGREGG INC.
HITK|HI-TECH PHARMACAL CO., INC.
HIBB|HIBBETT SPORTS INC
HTCO|HICKORY TECH CORP
ONE|HIGHER ONE HOLDINGS, INC.
SNLN|HIGHLAND / IBOXX SENIOR LOAN
HIW|HIGHWOODS PROPERTIES INC
HIL|HILL INTERNATIONAL INC
HRC|HILL-ROM HOLDINGS, INC
HI|HILLENBRAND, INC.
HSH|HILLSHIRE BRANDS CO
HTH|HILLTOP HOLDINGS INC
HTHIY|HITACHI LTD (ADR 10 COM)
HITT|HITTITE MICROWAVE CORPORATION
HFC|HOLLYFRONTIER CORP
HOLL|HOLLYWOOD MEDIA CORP
HOLX|HOLOGIC INCORPORATED
HOMB|HOME BANCSHARES, INC.
HBCP|HOME BANCORP INC
HD|THE HOME DEPOT, INC.
HOME|HOME FEDERAL BANCORP, INC.
HMIN|HOME INNS & HOTELS
HME|HOME PROPERTIES INC
AWAY|HOMEAWAY INC
HMST|HOMESTREET, INC.
HTBI|HOMETRUST BANCSHARES INC
HMC|HONDA MTR LTD (AMER SHS)
HON|HONEYWELL INTL INC
HKXCY|HONG KONG EXCHANGES & CLEARING
HKTV|HONG KONG TELEVISION NETWORK
HOFT|HOOKER FURNITURE CORP
HH|HOOPER HOLMES INC
HMN|HORACE MANN EDUCATORS CORP
HRZL|HORIZON LINES INC
HRL|HORMEL FOODS CORP
HRZN|HORIZON TECHNOLOGY FINANCE COR
HOS|HORNBECK OFFSHORE SERVICES INC
ZINC|HORSEHEAD HOLDING CORP.
HSP|HOSPIRA, INC.
HPT|HOSPITALITY PROPERTIES TRUST
HPTPRD|HOSPITALITY PROPERTIES TRUST
HST|HOST HOTELS & RESORTS INC
HWCC|HOUSTON WIRE & CABLE COMPANY
HOV|HOVNANIAN K ENTERPRISES INC
HOVU|HOVNANIAN ENTERPRISES INC
HHC|THE HOWARD HUGHES CORP
HUBG|HUB GROUP, INC
HUBA|HUBBELL INCORPORATED CLASS A
HUBB|HUBBELL INCORPORATED CLASS B
HBM|HUDBAY MINERALS INC.
HCBK|HUDSON CITY BANCORP INC
HSON|HUDSON GLOBAL, INC.
HPP|HUDSON PACIFIC PROPERTIES, INC
HPPPRB|HUDSON PACIFIC PROPERTIES, INC
HVB|HUDSON VALLEY HOLDING CORP
HUM|HUMANA INC.
JBHT|J B HUNT TRANS SVCS INC
HBAN|HUNTINGTON BANCSHARES INCORPOR
HII|HUNTINGTON INGALLS
HUN|HUNTSMAN CORPORATION
HURC|HURCO COMPANIES INC
HURN|HURON CONSULTING GROUP INC.
HTCH|HUTCHINSON TECHNOLOGIES
HUWHY|HUTCHISON WHAMPOA (ADR)
H|HYATT HOTELS CORPORATION
IDT|IDT CORPORATION
HPTX|HYPERION THERAPEUTICS INC
HY|HYSTER-YALE MATERIALS HANDLING
IACI|IAC/INTERACTIVECORP
ICFI|ICF INTERNATIONAL INC
ICGE|ICG GROUP INC
ICUI|ICU MEDICAL INC
ICAD|ICAD INC
IDSY|ID SYSTEMS INC
IPCM|IPC - THE HOSPITALIST COMPANY
SFI|ISTAR FINANCIAL INC.
ESI|ITT EDUCATIONAL SERVICES INC
XXIA|IXIA
IBKC|IBERIABANK CORPORATION
ITT|ITT CORPORATION
IAG|IAMGOLD CORPORATION
IBN|ICICI BANK LIMITED
ICON|ICONIX BRAND GROUP INC
IDA|IDACORP INC
IEX|IDEX CORPORATION
IDXX|IDEXX LABORATORIES
IGTE|IGATE CORPORATION
IRG|IGNITE RESTAURANT GROUP INC
IHS|IHS, INC.
ITW|ILLINOIS TOOL WORKS
ILMN|ILLUMINA INC
IMN|IMATION CORPORATION
IMAX|IMAX CORPORATION
IMMR|IMMERSION CORPORATION
IMGN|IMMUNOGEN INC.
IPXL|IMPAX LABORATORIES, INC.
IFT|IMPERIAL HOLDINGS, INC.
IPMLF|IMPERIAL METALS CORPORATION
IMMU|IMMUNOMEDICS INC
IMO|IMPERIAL OIL LIMITED
ITYBY|IMPERIAL TOBACCO GROUP PLC
IMPV|IMPERVA INC
IMRS|IMRIS INC.
SAAS|INCONTACT, INC.
INCY|INCYTE CORPORATION
IHC|INDEPENDENCE HOLDING COMPANY
IRT|INDEPENDENCE REALTY TRUST, INC
INDB|INDEPENDENT BANK CORP MASS
IBCP|INDEPENDENT BANK CORPORATION
IBTX|INDEPENDENT BANK GROUP INC
IDEXY|INDUSTRIA DE DISENO TEXTIL IND
IDCBY|INDUSTRIAL & COMMERCIAL BANK O
IBA|INDUSTRIAS BACHOCO S.A. ADR
INFI|INFINITY PHARMACEUTICALS INC
IPCC|INFINITY PPTY & CAS CORP
INFA|INFORMATICA CORP
INFN|INFINERA CORPORATION
BLOX|INFOBLOX INC.
III|INFORMATION SVCS GRP, INC.
INFY|INFOSYS LTD
IND|ING GROEP N.V.
ISG|ING GROEP N.V.
ISF|ING GROEP N.V.
IDG|ING GROEP N.V.
VOYA|ING AMERICA INSURANCE HOLDINGS
IMKTA|INGLES MARKETS INC CL-A
IM|INGRAM MICRO INC.
INGR|INGREDION INC
IRC|INLAND REAL ESTATE CORPORATION
INOD|INNODATA  INC
NSIT|INSIGHT ENTERPRISES INC
INSM|INSMED INC
INOC|INNOTRAC CORPORATION
IOSP|INNOSPEC CORPORTAION
ISSC|INNOVATIVE SOLUTIONS & SUPPORT
IPHI|INPHI CORPORATION
INWK|INNERWORKINGS INC
IPHS|INNOPHOS HOLDINGS INC.
IIIN|INSTEEL INDUSTRIES INC
NSP|INSPERITY INC
NSPR|INSPIREMD, INC.
PODD|INSULET CORPORATION
IPXHY|INPEX CORPORATION
IART|INTEGRA LIFESCIENCES HOLDING
IDTI|INTEGRATED DEVICE TECH INC
IESC|INTEGRATED ELECTRICAL SVC INC
ISSI|INTEGRATED SILICON SOLUTION
INTC|INTEL CORPORATION
TEG|INTEGRYS ENERGY GROUP, INC.
IEH|INTEGRYS ENERGY GROUP, INC.
INSY|INSYS THERAPEUTICS INC
IQNT|INTELIQUENT
IPAR|INTER PARFUMS INC
IBKR|INTERACTIVE BROKERS GROUP, INC
ININ|INTERACTIVE INTELLIGENCE INC
ICPT|INTERCEPT PHARMACEUTICALS, INC
TILE|INTERFACE INC.
ICE|INTRCONTINENTALEXCHANGE GP INC
IDCC|INTERDIGITAL INC
IMI|INTERMOLECULAR INC
ITMN|INTERMUNE, INC.
INAP|INTERNAP NETWORK SERVICES CORP
IBOC|INTERNATIONAL BANCSHARES CORP
IBM|INTL BUSINESS MACHINES CORP
IFF|INTL.FLAVORS & FRAGRANCE
IGT|INTL GAME TECHNOLOGY
IP|INTERNATIONAL PAPER CO.
IRF|INTL RECTIFIER CORP.
ISH|INTERNATIONAL SHIPHOLDING CP
ISCA|INTL SPEEDWAY CORP-CL A
INPH|INTERPHASE CORP
IPG|INTERPUBLIC GROUP COS
ISIL|INTERSIL CORP
IBCA|INTERVEST BANCSHARES CORP
INTX|INTERSECTIONS INC.
IILG|INTERVAL LEISURE GROUP, INC.
INTT|INTEST CORPORATION
IVAC|INTEVAC INC
ISNPY|INTESA SANPAOLO
INTL|INTL FCStone Inc
IL|INTRALINKS HOLDINGS, INC.
INTU|INTUIT INC
IVC|INVACARE CORP
ISRG|INTUITIVE SURGICAL, INC.
SNAK|INVENTURE FOODS INC
IVR|INVESCO MORTGAGE CAPITAL INC.
VTA|INVESCO DYNAMIC CREDIT
ITG|INVESTMENT TECHNOLOGY GP INC
ISBC|INVESTORS BANCORP, INC.
IRET|INVESTORS REAL ESTATE TRUST
IO|ION GEOPHYSICAL CORPORATION
IPAS|IPASS INC
IRIX|IRIDEX CORP
IRDM|IRIDIUM COMMUNICATIONS INC
IRBT|IROBOT CORPORATION
IRM|IRON MOUNTAIN INC
IRWD|IRONWOOD PHARMACEUTICALS, INC.
ISIS|ISIS PHARMACEUTICALS INC
ISLE|ISLE OF CAPRIS CASINO INC
ISRL|ISRAMCO INC (NEW)
ITUB|ITAU UNIBANCO BANCO HLDNG S.A
ITI|ITERIS INC
ITC|ITC HOLDINGS CORP.
ITRI|ITRON INC
IXYS|IXYS CORP
JJSF|J&J SNACK FOODS CORP
JDSU|JDS UNIPHASE CORPORATION
JPM|JPMORGAN CHASE & CO
NILSY|JSC MMC NORILSK NICKEL
*HYDRRLN|OPEN JOINT STOCK COMPANY RUSHY
JMP|JMP GROUP INC.
JBL|JABIL CIRCUIT INC
JPMWS|WTS/JPMORGAN CHASE & CO.
JACK|JACK IN THE BOX INC.
TAX|JTH HLDG INC
JEC|JACOBS ENGINEERING GRP
JMBA|JAMBA INC
JNS|JANUS CAPITAL GROUP INC.
JAH|JARDEN CORPORATION
JMI|JAVELIN MORTGAGE INVESTMENT CO
JBLU|JETBLUE AIRWAYS CORPORATION
JIVE|JIVE SOFTWARE, INC.
JOEZ|JOE'S JEANS INC
JBT|JOHN BEAN TECHNOLOGIES CORPORA
JNJ|JOHNSON & JOHNSON
JCI|JOHNSON CONTROLS INC
JOUT|JOHNSON OUTDOORS INC
JONE|JONES ENERGY, INC.
JLL|JONES LANG LASALLE INC
JNY|THE JONES GROUP INC
JOSB|JOS A BANK CLOTHIERS INC
JRN|JOURNAL COMMUNICATIONS INC
JOY|JOY GLOBAL INC.
JCOM|J2 GLOBAL INC.
JPMPRC|JPMORGAN CHASE CAPITAL XXIX
JNPR|JUNIPER NETWORKS, INC.
JE|JUST ENERGY GROUP INC.
KAR|KAR AUCTION SERVICES, INC.
KB|KB FINANCIAL GROUP INC.
KBR|KBR, INC.
KCG|KCG HOLDINGS, INC.
KLAC|KLA-TENCOR CORPORATION
KKR|KKR & CO. L.P.
KMG|KMG CHEMICALS, INC.
KVHI|KVH INDUSTRIES INC
LRN|K12 INC.
KAI|KADANT INCORPORATED
KALU|KAISER ALUMINUM CORPORATION
KBIO|KALOBIOS PHARMACEUTICALS INC
KAMN|KAMAN CORP
KCLI|KANSAS CITY LIFE INS
KSU|KANSAS CITY SOUTHERN
KCRPY|KAO CORP
KS|KAPSTONE PAPER AND PACKAGING
KED|KAYNE ANDERSON ENERGY
KBH|KB HOME
KCAP|KCAP FINANCIAL INC
KRNY|KEARNY FINL CORP
K|KELLOGG COMPANY
KELYA|KELLY SERVICES INC(CL-A)
KEM|KEMET CORPORATION
KMPR|KEMPER CORPORATION
KMT|KENNAMETAL INC.
KW|KENNEDY-WILSON HOLDINGS INC
PPRUY|KERING
KEQU|KEWAUNEE SCIENTIFIC CORP
KEG|KEY ENERGY SERVICES INC
KTEC|KEY TECHNOLOGY INC
KTCC|KEY TRONIC CORP
KEY|KEYCORP
KEYPRG|KEYCORP
KEYW|KEYW HOLDING CORP
KFRC|KFORCE INC
KID|KID BRANDS INC
KBALB|KIMBALL INTL INC CL-B
KRC|KILROY RLTY CORP
KMB|KIMBERLY CLARK CORP
KCDMY|KIMBERLY CLARK DE MEXICO S.A.
KIM|KIMCO REALTY CORPORATION
KIMPRK|KIMCO REALTY CORPORATION
KIMPRJ|KIMCO REALTY CORPORATION
KIMPRI|KIMCO REALTY CORPORATION
KIMPRH|KIMCO REALTY CORPORATION
KMI|KINDER MORGAN INC
KND|KINDRED HEALTHCARE INC.
KGFHY|KINGFISHER PLC
KGC|KINROSS GOLD CORP
KEX|KIRBY CORP
KIRK|KIRKLANDS INC
KRG|KITE REALTY GROUP TRUST
KRGPRA|KITE REALTY GROUP TRUST
KLNDF|KLONDEX MINES LTD
KNL|KNOLL INC
KNX|KNIGHT TRANSPORTATION INC
KHOLY|KOC HLDG
KOG|KODIAK OIL & GAS CORP
KSS|KOHL'S CORP (WISCONSIN)
KMTUY|KOMATSU LTD ADR (NEW)
AHONY|KONINKLIJKE AHOLD N.V.
PHG|KONINKLIJKE PHILIPS  N.V.
KONA|KONA GRILL, INC.
KONG|KONGZHONG CORP.
KOPN|KOPIN CORP
KOP|KOPPERS HOLDINGS INC.
KEP|KOREA ELECTRIC POWER CRP
KF|KOREA FUND INC, (THE)
KEF|KOREA EQUITY FUND
KFY|KORN/FERRY INTERNATIONAL
KRFT|KRAFT FOODS GROUP, INC.
KTOS|KRATOS DEFENSE & SECURITY SOL
KRA|KRATON PERFORMNC POLMERS INC.
KKD|KRISPY KREME DOUGHNUTS INC
KR|KROGER COMPANY
KRO|KRONOS WORLDWIDE INC
KLIC|KULICKE & SOFFA INDS INC
KYO|KYOCERA CORP ADR
KYTH|KYTHERA BIOPHARMACEUTICALS, IN
LTD|L BRANDS, INC.
LCAV|LCA-VISION INC
LDRH|LDR HOLDING CORPORATION
LPL|LG DISPLAY CO LTD
LHCG|LHC GROUP, LLC
LKQ|LKQ CORPORATION
LMIA|LMI AEROSPACE INC
LNBB|LNB BANCORP INC
LRLCY|L'OREAL CO (ADR)
LPLA|LPL FINL HLDGS INC
LRAD|LRAD CORP
LRE|LRR ENERGY LP
LXU|LSB INDUSTRIES INC
LSI|LSI CORPORATION
LYTS|LSI INDUSTRIES INC
LTC|LTC PROPERTIES INC
LTXC|LTX-CREDENCE CORP
LLL|L-3 COMMUNICATIONS HLDGS INC
LVMUY|LVMH MOET HENNESSY LOUIS
LZB|LA Z BOY CHAIR CO
LH|LABORATORY CORPORATION OF AMER
LG|LACLEDE GROUP, INC. (THE)
LTS|LADENBURG THALMAN FIN SVCS INC
LBAI|LAKELAND BANCORP INC (DEL)
LKFN|LAKELAND FINL CORP
LAKE|LAKELAND INDUSTRIES INC
LACO|LAKES ENTERTAINMENT INC
LRCX|LAM RESEARCH CORP
LAMR|LAMAR ADVERTISING CO
LANC|LANCASTER COLONY CORP
LNDC|LANDEC CORP
LDR|LANDAUER INC
LSTR|LANDSTAR SYSTEM INC
LCI|LANNETT COMPANY, INC
LPI|LAREDO PETROLEUM HOLDINGS, INC
LVS|LAS VEGAS SANDS CORP.
LHO|LASALLE HOTEL PROPERTIES
LHOPRH|LASALLE HOTEL PROPERTIES
LDF|LATIN AMERICAN
LSCC|LATTICE SEMICONDUCTOR CORP
EL|ESTEE LAUDER COS INC CL-A
LAWS|LAWSON PRODUCTS INC
LAYN|LAYNE CHRISTENSEN COMPANY
LGI|LAZARD GLOBAL TOTAL RETURN AND
LEAP|LEAP WIRELESS INTL INC
LEA|LEAR CORPORATION
LTRE|LEARNING TREE INTL INC
LEE|LEE ENTERPRISES INC
LEG|LEGGETT & PLATT INC
LM|LEGG MASON INC
LDOS|LEIDOS HLDGS INC
LMAT|LEMAITRE VASCULAR, INC.
LPS|LENDER PROCESSING SERVICES, IN
LEN|LENNAR CORPORATION
LENB|LENNAR CORP
LII|LENNOX INTERNATIONAL INC
LNVGY|LENOVO GROUP LIMITED
LUK|LEUCADIA NATIONAL CORP
LVLT|LEVEL 3 COMMUNICATIONS INC
LXRX|LEXICON PHARMACEUTICALS INC
LXP|LEXINGTON REALTY TRUST
LXK|LEXMARK INTERNATIONAL INC.
LBY|LIBBEY INC.
LINTA|LIBERTY INTERACTIVE CORP
LVNTA|LIBERTY VENTURES
LRY|LIBERTY PROPERTY TRUST SBI
LMCA|LIBERTY MEDIA CORPORATION
LMCB|LIBERTY MEDIA CORPORATION
LWAY|LIFEWAY FOODS INC
LTM|LIFE TIME FITNESS, INC.
LIFE|LIFE TECHNOLOGIES CORPORATION
LPNT|LIFEPOINT HOSPITALS INC
LGND|LIGAND PHARMACEUTICALS INC
LCUT|LIFETIME BRANDS INC
LOCK|LIFELOCK, INC.
LLY|ELI LILLY & CO
LLNW|LIMELIGHT NETWORKS, INC.
LMNR|LIMONEIRA CO
LIN|LIN MEDIA LLC
LINC|LINCOLN EDL SERVICES CORP
LECO|LINCOLN ELECTRIC HOLDINGS INC
LNC|LINCOLN NATL.CORP.INC.
LNCWS|WTS/LINCOLN NATIONAL CORP
LNN|LINDSAY CORPORATION
LLTC|LINEAR TECHNOLOGY CORP
LNKD|LINKEDIN CORP
LGF|LIONS GATE ENTERTAINMENT CORP
LIOX|LIONBRIDGE TECHNOLOGIES INC
LPDX|LIPOSCIENCE, INC.
LAD|LITHIA MOTORS INC CL-A
LFUS|LITTELFUSE INC
LYV|LIVE NATION ENTERTAINMENT INC
LPSN|LIVEPERSON INC
LYGPRA|LLOYDS BANKING GROUP PLC
LOJN|LO JACK CORP
LMT|LOCKHEED MARTIN CORPORATION
L|LOEWS CORPORATION
LOGM|LOGMEIN INC
LORL|LORAL SPACE &COMMUNICATION INC
LO|LORILLARD, INC.
LPX|LOUISIANA PACIFIC CORP
LOW|LOWES COMPANIES INC
LUB|LUBYS INC CMN STOCK
LEI|LUCAS ENERGY, INC.
LULU|LULULEMON ATHLETICA INC.
LL|LUMBER LIQUIDATORS HOLDINGS IN
LMNX|LUMINEX CORP DEL
LMOS|LUMOS NETWORKS CORP
LXFR|LUXFER HOLDINGS PLC
LUX|LUXOTTICA GROUP ADS(SPONSORED)
LDL|LYDALL INC
WLH|WILLIAM LYON HOMES INC
MTB|M&T BANK CORPORATION
MTBWS|WTS/M&T BANK CORPORATION
MBI|MBIA INC
MBFI|MB FINANCIAL INC NEW
MDC|M.D.C.HOLDINGS,INC (DELAWARE)
MDU|MDU RESOURCES GROUP INC
MDCA|MDC PARTNERS INC
MFRI|MFRI INC
MFA|MFA FINANCIAL INC
MMT|MFS MULTIMARKET INCOME TR SBI
MGCD|MGC DIAGNOSTICS CORP
MGEE|MGE ENERGY INC
MAMS|MAM SOFTWARE GROUP INC
MTG|MGIC INVESTMENT CORP
MTBPRA|M&T CAPITAL TRUST IV
MGM|MGM RESORTS INTERNATIONAL
MGPI|MGP INGREDIENTS INC
MHO|M/I HOMES INC
MKSI|MKS INSTRUMENTS INC
MPLX|MPLX LP
MRC|MRC GLOBAL INC.
MRVC|MRV COMMUNICATIONS, INC.
MSADY|MS&AD INSURANCE GROUP HOLDINGS
MSM|MSC INDUSTRIAL DIRECT CO INC
MSCI|MSCI INC.
MNTG|M T R GAMING GROUP INC
MTSC|MTS SYSTEMS CORP
MVC|MVC CAPITAL INC
MWIV|MWI VETERINARY SUPPLY, INC.
MYRG|MYR GROUP INC.
MTSI|MA COM TECHNOLOGY SOLUTIONS
TUC|MAC-GRAY CORP
MCBC|MACATAWA BK CORP.
MAC|MACERICH COMPANY
CLI|MACK-CALI REALTY CORP
MIC|MACQUARIE INFRASTRUCTURE CO LL
MGNX|MACROGENICS, INC.
M|MACY'S INC.
SHOO|STEVEN MADDEN LTD
MSG|THE MADISON SQUARE GARDEN CO
MVG|MAG SILVER CORP.
MGLN|MAGELLAN HEALTH SERVICES, INC.
MMP|MAGELLAN MIDSTREAM PARTNERS LP
MPET|MAGELLAN PETROLEUM CORP
MGA|MAGNA INTERNATIONAL INC.
MX|MAGNACHIP SEMICONDUCTOR CORP
MAG|MAGNETEK, INC.
MHR|MAGNUM HUNTER RESOURCES CORPOR
MHRPRD|MAGNUM HUNTER RESOURCES INC.
MAIN|MAIN STREET CAPITAL CORP
MSFG|MAINSOURCE FINANCIAL GP INC
MKTAY|MAKITA CORP SPONS. (ADR)
MANH|MANHATTAN ASSOCIATES INC
MTW|MANITOWOC CO INC
MTEX|MANNATEC, INC.
MN|MANNING & NAPIER INC
MNKDW|WTS/MANNKIND CORPORATION
MAN|MANPOWER GROUP
MANT|MANTECH INTERNATIONAL CORP
MFC|MANULIFE FINANCIAL CORP
MRO|MARATHON OIL CORPORATION
MPC|MARATHON PETROLEUM CORPORATION
MCHX|MARCHEX INC
MCS|MARCUS CORP
HZO|MARINEMAX INC
MRIN|MARIN SOFTWARE INC
MPX|MARINE PRODUCTS CORPORATION
MKL|MARKEL CORPORATION
MKTX|MARKETAXESS HOLDINGS INC.
MKTO|MARKETO INC.
MWE|MARKWEST ENERGY PARTNERS, L.P.
MAKSY|MARKS AND SPENCER P.L.C.
MRLN|MARLIN BUSINESS SERVICES, INC.
VAC|MARRIOTT VACATIONS WORLDWIDE
MMC|MARSH & MCLENNAN CO INC
MAR|MARRIOTT INTERNATIONAL, INC.
MRTN|MARTEN TRANSPORT LTD
MSO|MARTHA STEWART LIVING
MLM|MARTIN MARIETTA MATERIALS,INC
MMLP|MARTIN MIDSTREAM, L.P.
MAS|MASCO CORPORATION
MASI|MASIMO CORPORATION
DOOR|MASONITE INTL CORP NEW
MTZ|MASTEC INC
MHH|MASTECH HOLDINGS, INC
MA|MASTERCARD INCORPORATED
MTDR|MATADOR RES CO
MASC|MATERIAL SCIENCES CORP
MTRN|MATERION CORPORATION
MTRX|MATRIX SERVICE COMPANY
MATX|MATSON, INC.
MAT|MATTEL, INC.
MATW|MATTHEWS INTL CORP CL-A
MTSN|MATTSON TECHNOLOGY INC
MFRM|MATTRESS FIRM HLDG CORP
MLP|MAUI LAND & PINEAPPLE CO
MXIM|MAXIM INTEGRATED PRODUCTS INC
MXWL|MAXWELL TECHNOLOGIES INC.
MXL|MAXLINEAR INC
MMS|MAXIMUS INC
MNI|MC CLATCHY COMPANY (HLDG CO)
MKC|MCCORMICK & CO NON VTG SHRS
MDR|MCDERMOTT INTL
MCD|MC DONALDS CORP
MUX|MCEWEN MINING INC
MCGC|MCG CAPITAL
MGRC|MCGRATH RENTCORP
MHFI|MCGRAW-HILL COMPANIES INC
MCK|MCKESSON CORPORATION
MJN|MEAD JOHNSON NUTRITION COMPANY
MIG|MEADOWBROOK INSURANCE GROUP
MWV|MEADWESTVACO CORP
MEAS|MEASUREMENT SPECIALTIES INC
TAXI|MEDALLION FINANCIAL CORP
MDAS|MEDASSETS, INC.
MEG|MEDIA GENERAL INC
MDCI|MEDICAL ACTION
MPW|MEDICAL PROPERTIES TRUST INC
MDCO|MEDICINES CO (THE)
MED|MEDIFAST, INC.
MDSO|MEDIDATA SOLUTIONS, INC.
MDVN|MEDIVATION INC.
MD|MEDNAX INC
MCC|MEDLEY CAPITAL CORPORATION
MDT|MEDTRONIC INC
MPEL|MELCO CROWN ENTERTAINMENT LIMI
MW|MENS WEARHOUSE INC (THE)
MENT|MENTOR GRAPHICS CORP
MBWM|MERCANTILE BANK CORP
MERC|MERCER INTERNATIONAL INC
MBVT|MERCHANTS BANCSHARES INC
MRK|MERCK & CO., INC.
MRCY|MERCURY SYSTEMS INC
MCY|MERCURY GENERAL CORPORATION
MDP|MEREDITH CORP.
MRGE|MERGE HEALTHCARE INC.
VIVO|MERIDIAN BIOSCIENCE INC
EBSB|MERIDIAN INTERSTATE BANCORP, I
MMSI|MERIT MEDICAL SYS INC
MTH|MERITAGE HOMES CORPORATION
MTOR|MERITOR INC
MLAB|MESA LABORATORIES INC
MEA|METALICO, INC.
MEOH|METHANEX CORPORATION
MEI|METHODE ELECTRONICS, INC
MET|METLIFE, INC.
MLU|METLIFE, INC.
METPRB|METLIFE, INC
METR|METRO BANCORP INC
MCBI|METROCORP BANCSHARES
MTD|METTLER-TOLEDO INTL
MCRL|MICREL INC
MCRS|MICROS SYSTEMS, INC.
MSFT|MICROSOFT CORPORATION
MSTR|MICROSTRATEGY INC
MFI|MICROFINANCIAL INCORPORATED
MU|MICRON TECHNOLOGY, INC.
MSCC|MICROSEMI CORP CL A
MAA|MID-AMERICA APT CMNTYS INC
MIDD|MIDDLEBY CORP
MSEX|MIDDLESEX WATER CO
MSL|MIDSOUTH BANCORP, INC.
MDW|MIDWAY GOLD CORP.
MOFG|MIDWESTONE FINANCIAL GROUP INC
MILL|MILLER ENERGY RES INC
MLHR|MILLER HERMAN INC.
MLR|MILLER INDS INC
MDXG|MIMEDX GROUP, INC
MSA|MINE SAFETY APPLIANCES CO INC
MTX|MINERALS TECHNOLOGIES INC
MSON|MISONIX INC
MG|MISTRAS GROUP, INC.
MIND|MITCHAM INDS INC
MITK|MITEK SYSTEMS INC (NEW)
MSBHY|MITSUBISHI CORP SPONS ADR
MTU|MITSUBISHI UFJ FINL GROUP, INC
MITSY|MITSUI & CO LTD
MFG|MIZUHO FINANCIAL GROUP, INC.
MIXT|MIX TELEMATICS LIMITED
MBT|MOBILE TELESYSTEMS OJSC
MINI|MOBILE MINI INC
MOCO|MOCON INC
MOD|MODINE MFG CO
MLNK|MODUSLINK GLOBAL SOLUTIONS, IN
MHK|MOHAWK INDUSTRIES INC
MOLX|MOLEX INC
MOLXA|MOLEX INC CLASS-A
MOH|MOLINA HEALTHCARE, INC.
TAP|MOLSON COORS BREWING CO
MNTA|MOMENTA PHARMACEUTICALS, INC.
MCRI|MONARCH CASINO & RESORT INC
MDLZ|MONDELEZ INTERNATIONAL, INC.
MGI|MONEYGRAM INTERNATIONAL, INC.
MNGGF|MONGOLIA GROWTH GROUP LTD.
MNR|MONMOUTH REAL ESTATE INVESTMEN
MNRPRA|MONMOUTH REAL ESTATE
MPWR|MONOLITHIC POWER SYSTEMS, INC.
TYPE|MONOTYPE IMAGING HOLDINGS INC.
MNRO|MONRO MUFFLER BRAKE, INC.
MON|MONSANTO COMPANY
MNST|MONSTER BEVERAGE CORP
MWW|MONSTER WORLDWIDE INC.
MCO|MOODYS CORP
MOGA|MOOG INC CL A
RNE|MORGAN STANLEY EASTERN
MS|MORGAN STANLEY
APF|MORGAN STANLEY ASIA
MWR|MORGAN STANLEY CAP TR III
MSJ|MORGAN STANLEY CAPITAL TRT VI
CAF|MORGAN STANLEY CHINA
MSPRA|MORGAN STANLEY
MHGC|MORGANS HOTEL GROUP CO
MSZ|MORGAN STANLEY CAP TR VII
MSK|MORGAN STANLEY CAPITAL
MSPRE|MORGAN STANLEY
MORN|MORNINGSTAR, INC.
MOS|THE MOSAIC COMPANY
MOSY|MOSYS INC
MPAA|MOTORCAR PARTS OF AMERICA, INC
MSI|MOTOROLA SOLUTIONS INC
MOV|MOVADO GROUP INC
MOVE|MOVE INC
MTNOY|MTN GROUP LTD
MUEL|PAUL MUELLER COMPANY
MLI|MUELLER INDUSTRIES INC
MWA|MUELLER WATER PRODUCTS, INC.
LABL|MULTI-COLOR CORP
MFLX|MULTI-FINELINE ELECTRONIX INC
MGAM|MULTIMEDIA GAMES INC
MUR|MURPHY OIL CORPORATION
MUSA|MURPHY USA INC
MFSF|MUTUALFIRST FINL INC
MYE|MYERS INDS INC
MYL|MYLAN INC
NBTB|NBT BANCORP INC
NCS|NCI BUILDING SYSTEMS, INC.
NCR|NCR CORPORATION
NCIT|NCI, INC.
NASB|NASB FINANCIAL INC
NGPC|NGP CAPITAL
NGL|NGL ENERGY PARTNERS LP
EGOV|NIC INC
NL|NL INDS INC NEW
NNBR|NN INC
NPSP|NPS PHARMACEUTICALS INC
NRG|NRG ENERGY, INC.
DCM|NTT DOCOMO, INC.
NYLD|NRG YIELD, INC.
NVEC|NVE CORP
NVR|N V R INC
NC|NACCO INDS INC CL-A (COM)
NTE|NAM TAI ELECTRONICS INC
NANO|NANOMETRICS INC
NSPH|NANOSPHERE, INC.
NSTG|NANOSTRING TECHNOLOGIES, INC.
NSSC|NAPCO SECURITY TECHNOLOGIES, I
NDAQ|NASDAQ OMX GROUP, INC.
NPSNY|NASPERS LTD
NATH|NATHANS FAMOUS INC
NABZY|NATIONAL AUSTRALIA BANK LIMITE
NBHC|NATIONAL BANK HOLDINGS CORP
NKSH|NATIONAL BANKSHARES INC VA
FIZZ|NATIONAL BEVERAGE CORP
NCMI|NATIONAL CINEMEDIA, INC.
NHC|NATIONAL HEALTHCARE CORP
NFG|NATIONAL FUEL GAS CO
NGG|NATIONAL GRID PLC
NHI|NATIONAL HEALTH INVESTORS, INC
NATI|NATIONAL INSTRUMENTS CORP
NATL|NATIONAL INTERSTATE CORP
NOV|NATIONAL OILWELL VARCO, INC.
NPBC|NATIONAL PENN BANCSHARES
NPK|NATIONAL PRESTO IND. INC
NRCIA|NATIONAL RESEARCH CORPORATION
NNN|NATIONAL RETAIL PROPERTIES INC
NNNPRD|NATL RETAIL PROPERTIES, INC.
NNNPRE|NATIONAL RETAIL PROPERTIES INC
NTSC|NATIONAL TECHNICAL SYSTEMS
NWLI|NATL WESTN LIFE INS CO CL-A
NAII|NATURAL ALTERNATIVES INTL INC
NGS|NATURAL GAS SERVICES GROUP, IN
NGVC|NATURAL GROCERS BY VITAMIN
NAVG|NAVIGATORS GROUP INC
NRP|NATURAL RESOURCE PARTNERS
NATR|NATURES SUNSHINE PRODS INC
BABY|NATUS MEDICAL INC DEL
NTZ|NATUZZI SPA
NLS|NAUTILUS INC
NAV|NAVISTAR INTL CORP (NEW)
NCI|NAVIGANT CONSULTING INC
NAVB|NAVIDEA BIOPHARMACEUTICALS INC
NDBKY|NEDBANK GROUP LTD
NP|NEENAH PAPER INC
NKTR|NEKTAR THERAPEUTICS
NNI|NELNET, INC.
NEOG|NEOGEN CORP
NEO|NEOGENOMICS INC
NPTN|NEOPHOTONICS CORP
NBS|NEOSTEM, INC.
NSRGY|NESTLE SA SPONSORED ADR
UEPS|NET 1 UEPS TECHNOLOGIES INC
NTAP|NETAPP, INC.
NTES|NETEASE INC
NTGR|NETGEAR, INC.
NTCT|NETSCOUT SYSTEMS INC
N|NETSUITE INC.
NBIX|NEUROCRINE BIOSCIENCES INC
NSR|NEUSTAR INC.
NSU|NEVSUN RESOURCES LTD
NGD|NEW GOLD INC
NJR|NEW JERSEY RESOURCES CORPORATI
NMFC|NEW MOUNTAIN FINANCE CORP
EDU|NEW ORIENTAL ED & TECH GRP
NRZ|NEW RESIDENTIAL INVESTMENT COR
NWY|NEW YORK & COMPANY, INC.
NYCB|NEW YORK COMMUNITY BANCORP INC
NYMT|NEW YORK MORTGAGE TRUST, INC.
NYT|NEW YORK TIMES CO.A
NBBC|NEWBRIDGE BANCORP
NWL|NEWELL RUBBERMAID INC
NFX|NEWFIELD EXPLORATION CO.
NLNK|NEWLINK GENETICS CORPORATION
NEU|NEWMARKET CORP
NEM|NEWMONT MINING CORPORATION
NR|NEWPARK RES INC
NEWP|NEWPORT CORP
NWSA|NEWS CORPORATION
NWS|NEWS CORPORATION
NEWS|NEWSTAR FINANCIAL, INC.
NXST|NEXSTAR BROADCASTING GRP, INC
NEE|NEXTERA ENERGY, INC.
NEEPRP|NEXTERA ENERGY, INC.
NEEPRO|NEXTERA ENERGY, INC.
NEEPRF|NEXTERA ENERGY CAPITAL HLDGS
NEEPRH|NEXTERA ENERGY CAPITAL HLD INC
NEEPRI|NEXTERA ENERGY CAPITAL
NEEPRJ|NEXTERA ENERGY CAPITAL HOLDING
NICE|NICE SYSTEMS LTD
NKE|NIKE CLASS-B
NTT|NIPPON TELEG & TEL SPON ADR
NI|NISOURCE INC
NDEKY|NITTO DENKO CORP.
NOK|NOKIA CORP SPON ADR
NBL|NOBLE ENERGY INC
NKRKY|NOKIAN RENKAAT OY
NOR|NORANDA ALUMINUM HOLDING CORP
NDZ|NORDION INC.
NDSN|NORDSON CORP
JWN|NORDSTROM INC
NSC|NORFOLK SOUTHERN CORPORATION
NTK|NORTEK, INC.
NTL|NORTEL INVERSORA ADR
NOA|NORTH AMERICAN ENERGY
NOVB|NORTH VALLEY BANCORP
NBN|NORTHEAST BANCORP
NU|NORTHEAST UTILITIES
NAK|NORTHERN DYNASTY MINERALS LTD
NOG|NORTHERN OIL AND GAS, INC.
NTRS|NORTHERN TRUST CORP
NFBK|NORTHFIELD BANCORP, INC.
NRIM|NORTHRIM BANCORP INC
NOC|NORTHROP GRUMMAN CORP
NRF|NORTHSTAR REALTY FINANCE CORP.
NRFPRC|NORTHSTAR REALTY FINANCE CORP.
NRFPRD|NORTHSTAR REALTY FINANCE CORP.
NWBI|NORTHWEST BANCSHARES INC
NWN|NORTHWEST NATURAL GAS CO
NWPX|NORTHWEST PIPE COMPANY
NWE|NORTHWESTERN CORPORATION
NG|NOVAGOLD RESOURCES INC.
NVDQ|NOVADAQ TECHNOLOGIES INC
NVTL|NOVATEL WIRELESS INC
NVS|NOVARTIS AG-ADR
NCQ|NOVACOPPER INC.
NVAX|NOVAVAX INC
NVO|NOVO-NORDISK A/S ADR
NUS|NU SKIN ENTERPRISES INC
NTLS|NTELOS HOLDING CORP.
NUAN|NUANCE COMMUNICATIONS, INC.
NUE|NUCOR CORPORATION
NMRX|NUMEREX CORP CL-A
NSH|NUSTAR GP HOLDINGS, LLC
NUTR|NUTRACEUTICAL INTL CORP
NVDA|NVIDIA CORP
NTRI|NUTRISYSTEM, INC.
NUVA|NUVASIVE, INC.
JTP|NUVEEN QUALITY
NXTM|NXSTAGE MEDICAL INC
JLS|NUVEEN MORTGAGE OPP TERM FUND
NVE|NV ENERGY INC
OCIR|OCI RESOURCES LP
OGE|OGE ENERGY CORP (HOLDING CO)
OMG|OM GROUP INC
ORLY|O'REILLY AUTOMOTIVE INC
OFG|OFG BANCORP
OSIS|OSI SYSTEMS INC
OIIM|O2MICRO INTERNATIONAL LIMITED
OAS|OASIS PETROLEM INC
OXY|OCCIDENTAL PETROLEUM CORP
OII|OCEANEERING INTL INC
OCFC|OCEANFIRST FINANCIAL CORP
OCN|OCWEN FINANCIAL CORPORATION
ODP|OFFICE DEPOT INC
LUKOY|LUKOIL OIL CO SPONS ADR
ODC|OIL-DRI CORPORATION OF AMERICA
OIS|OIL STS INTL INC
ODFL|OLD DOMINION FGHT LINES INC
ONB|OLD NATIONAL BANCORP
ORI|OLD REPUBLIC INTL CORP
OSBC|OLD SECOND BANCORP INC ILL
OLN|OLIN CORP NEW $1 PAR
ZEUS|OLYMPIC STEEL, INC.
OCR|OMNICARE INC.
OMC|OMNICOM GROUP
OHI|OMEGA HEALTHCARE INVESTORS INC
OFLX|OMEGAFLEX, INC.
OME|OMEGA PROTEIN CORPORATION
OVTI|OMNIVISION TECHNOLOGIES INC
OMN|OMNOVA SOLUTIONS INC
OMCL|OMNICELL INC
ASGN|ON-ASSIGNMENT INC
OABC|OMNIAMERICAN BANCORP INC
ONNN|ON SEMICONDUCTOR CORP
ONTY|ONCOTHYREON INC
ONTX|ONCONOVA THERAPEUTICS INC
OLP|ONE LIBERTY PROPERTIES INC
FLWS|1-800-FLOWERS.COM
OKE|ONEOK INC
OKS|ONEOK PARTNERS, L.P.
OTEX|OPEN TEXT CORP
OPEN|OPENTABLE, INC.
OPLK|OPLINK COMMUNICATIONS INC
OPY|OPPENHEIMER HOLDINGS INC
ORCL|ORACLE CORPORATION
ORAN|ORANGE
OSUR|ORASURE TECHNOLOGIES INC
ORBC|ORBCOMM INC.
ORB|ORBITAL SCIENCES CORP
OWW|ORBITZ WORLDWIDE INC
TIS|ORCHIDS PAPER PRODUCTS COMPANY
OREX|OREXIGEN THERAPEUTICS, INC.
OESX|ORION ENERGY SYSTEMS, INC.
ORN|ORION MARINE GROUP INC
IX|ORIX CORPORATION SPONS ADR
ORIT|ORITANI FINANCIAL CORP.
ORA|ORMAT TECHNOLOGIES, INC.
ORRF|ORRSTOWN FINANCIAL SERVICES IN
OSK|OSHKOSH CORPORATION
OTTR|OTTER TAIL CORPORATION
OVAS|OVASCIENCE INC
OSGIQ|OVERSEAS SHIPHOLDING GRP
OSTK|OVERSTOCK.COM INC DEL
OMI|OWENS & MINOR INC (NEW)
OC|OWENS CORNING
OI|OWENS-ILLINOIS INC
OXM|OXFORD IND INC
PTSI|P.A.M. TRANSPORTATION SVCS INC
PCCC|PC CONNECTION INC.
PCMI|PCM INC
PCTI|PC-TEL INC
PDCE|PDC ENERGY INC
PDFS|PDF SOLUTIONS INC
PDII|PDI INC
PCG|P G & E CORPORATION
PHH|PHH CORPORATION
PICO|PICO HOLDINGS INC
PHII|PHI INC
PHIIK|PHI INC
PGTI|PGT INC
PLXT|PLX TECHNOLOGY INC
PCC|PMC COML TR SHS BEN INT
PMCS|PMC-SIERRA INC
PMFG|PMFG INC
PNC|PNC FINANCIAL SERVICES GROUP
PNCWS|WTS/THE PNC FINANCIAL SERVICES
PNCPRQ|PNC FINANCIAL SERVICES GRP INC
PNCPRP|THE PNC FINANCIAL
PKX|POSCO
PNM|PNM RESOURCES INC
PPG|PPG INDUSTRIES, INC.
PPL|PPL CORPORATION
PPLPRW|PPL CORPORATION
PRGX|PRGX GLOBAL INC
PSB|PS BUSINESS PARKS, INC.
PSBPRV|PS BUSINESS PARKS, INC.
PSBPRU|PS BUSINESS PARKS, INC.
PSBPRS|PS BUSINESS PARKS, INC.
PSBPRR|PS BUSINESS PARKS, INC.
PEXNY|PTT EXPLORATION AND PRODUCTION
PVH|PVH CORP
PVR|PVR PARTNERS, L.P.
PTCT|PTC THERAPEUTICS, INC.
PMTC|PTC INC
PCAR|PACCAR INC
PACR|PACER INTERNATIONAL INC
PACB|PACIFIC BIOSCIENCES OF
PCBK|PACIFIC CONTINENTAL CORP
PFLC|PACIFIC FINL CORP
PMBC|PACIFIC MERCANTILE BANCORP
PSUN|PACIFIC SUNWEAR OF CALIFORNIA
PCRX|PACIRA PHARMACEUTICALS, INC.
PKG|PACKAGING CORP OF AMERICA
PACT|PACTERA TECHNLGY INTERNATINAL
PACW|PACWEST BANCORP
PTIE|PAIN THERAPEUTICS INC
PLL|PALL CORP
PANW|PALO ALTO NETWORKS INC.
PAAS|PAN AMERICAN SILVER CORPORATIO
PCRFY|PANASONIC CORPORATION
P|PANDORA MEDIA, INC.
PNRA|PANERA BREAD COMPANY CL-A
PHX|PANHANDLE OIL AND GAS INC
PTRY|THE PANTRY INC
PZZA|PAPA JOHN'S INTERNATIONAL INC.
PAR|PAR TECHNOLOGY CORP
PRGN|PARAGON SHIPPING INC
PRXL|PAREXEL INTERNATIONAL CORP
PCYG|PARK CITY GROUP, INC.
PKE|PARK ELECTROCHEMICAL CRP
PRK|PARK NATIONAL CORPORATION
PKOH|PARK-OHIO HOLDINGS CORP
PSTB|PARK STERLING BANK
PKD|PARKER DRILLING CO.
PH|PARKER-HANNIFIN CORP.
PKY|PARKWAY PROPERTIES INC MD
PATK|PATRICK INDS INC
PATR|PATRIOT TRANSN HLDG INC
PEGI|PATTERN ENERGY GROUP INC.
PDCO|PATTERSON COMPANIES INC
PTEN|PATTERSON-UTI ENERGY, INC.
PAYX|PAYCHEX, INC.
BTU|PEABODY ENERGY CORPORATION
PSO|PEARSON PLC SPON ADR
PEB|PEBBLEBROOK HOTEL TRUST
PEBPRA|PEBBLEBROOK HOTEL TRUST
PEBPRC|PEBBLEBROOK HOTEL TRUST
PEGA|PEGASYSTEMS INC
PBA|PEMBINA PIPELINE CORPORATION
PCO|PENDRELL CORPORATION
PENX|PENFORD CORPORATION
PGH|PENGROWTH ENERGY CORP
PENN|PENN NATIONAL GAMING INC
PVA|PENN VA CORP
PWE|PENN WEST PETROLEUM LTD.
PNNT|PENNANTPARK INVESTMENT CORP
PWOD|PENNS WOODS BANCORP INC
PEI|PENN REAL EST INV TRUST
PMT|PENNYMAC MTG INVT TR
PFSI|PENNYMAC FINL SVCS INC
PAG|PENSKE AUTOMOTIVE GROUP, INC.
PEBO|PEOPLES BANCORP INC
PEOP|PEOPLES FED BANCSHARES INC
PBCT|PEOPLES UNITED FINANCIAL INC
PBY|PEP BOYS MANNY-MOE &JACK
POM|PEPCO HOLDINGS INC
PEP|PEPSICO INC
PRCP|PERCEPTRON INC
PPHM|PEREGRINE PHARMACEUTICALS INC
PSMI|PEREGRINE SEMICONDUCTOR CORP
PWRD|PERFECT WORLD CO., LTD.
PRFT|PERFICIENT INC
PTIX|PERFORMANCE TECHNOLOGIES INC
PFMT|PERFORMANT FINANCIAL CORP
PSEM|PERICOM SEMICONDUCTOR CORP
PKI|PERKINELMER INC
PESI|PERMA-FIX ENVIRONMENTAL SVCS
TLK|P.T. TELEKOMUNIKASI INDONESIA
PETS|PETMED EXPRESS, INC.
PTR|PETROCHINA CO LTD
PZE|PETROBRAS ENERGIA S.A.
PEO|PETROL & RESOURCES CORP
PBRA|PETROLEO BRASILEIRO S.A.
PBR|PETROLEO BRASILEIRO S.A. - PET
PDH|PETROLOGISTICS LP
PQ|PETROQUEST ENERGY, INC.
PETM|PETSMART, INC.
PCYC|PHARMACYCLICS INC
PFE|PFIZER INC.
PFSW|PFSWEB INC
PMC|PHARMERICA CORPORATION
PIP|PHARMATHENE INC
PM|PHILIP MORRIS INTL INC
PHI|PHILIPPINE LONG DISTANCE TEL
PSX|PHILLIPS 66
PNX|PHOENIX COMPANIES INC. (THE)
FENG|PHOENIX NEW MEDIA LIMITED
PLAB|PHOTRONICS INC
DOC|PHYSICIANS RLTY TR
PNY|PIEDMONT NATURAL GAS CO INC
PDM|PIEDMONT OFFICE REALTY TRUST I
PIR|PIER 1 IMPORTS INC (DELAWARE)
PIKE|PIKE CORP.
PPC|PILGRIM'S PRIDE CORPORATION
PFN|PIMCO FLOATING RATE
PDI|PIMCO DYNAMIC INCOME FD
PNGAY|PING AN INS GRP CO OF CHINA
PNK|PINNACLE ENTMT INC
PNFP|PINNACLE FINL PARTNERS INC
PNW|PINNACLE WEST CAPITAL CORP
PF|PINNACLE FOODS INC.
PES|PIONEER ENERGY SERVICES CORP
PXD|PIONEER NATURAL RESOURCES CO
PJC|PIPER JAFFRAY COMPANIES
PBI|PITNEY-BOWES INC
PAA|PLAINS ALL AMERICAN PIPELINE
PAGP|PLAINS GP HOLDINGS, L.P.
PLNR|PLANAR SYSTEMS INC.
PLT|PLANTRONICS INC
PLXS|PLEXUS CORP
PCL|PLUM CREEK TIMBER COMPANY INC
PGEM|PLY GEM HOLDINGS, INC.
PCOM|POINTS INTL LTD
PII|POLARIS INDS INC
POL|POLYONE CORP
PLZLY|POLYUS GOLD INT LTD
POOL|POOL CORP
BPOP|POPULAR, INC.
PRAA|PORTFOLIO RECOVERY ASSOCS INC
POR|PORTLAND GENERAL ELECTRIC CO
PTLA|PORTOLA PHARMACEUTICALS, INC.
PT|PORTUGAL TELECOM SGPS SA
POST|POST HOLDINGS, INC.
PPSPRA|POST PROPERITES
POT|POTASH CORP OF SASKATCHEWAN
PCH|POTLATCH CORPORATION
POWL|POWELL INDS INC
POWI|POWER INTEGRATIONS INC
CHNA|POWERSHARES ACTIVELY MANAGED
POWR|POWERSECURE INTERNATIONAL INC
POZN|POZEN INC
PX|PRAXAIR, INC
PCP|PRECISION CASTPARTS CORP.
PDS|PRECISION DRILLING CORP
PFBC|PREFERRED BK LOS ANGELES CA
PLPC|PREFORMED LINE PRODS CO
PINC|PREMIER INC
PGI|PREMIERE GLOBAL SVCS INC
PBH|PRESTIGE BRANDS HOLDINGS, INC.
TROW|PRICE T ROWE GROUP INC
PCLN|PRICELINE.COM INC
PSMT|PRICESMART INC
PRIM|PRIMORIS SERVICES CORPORATION
PRI|PRIMERICA INC.
PPP|PRIMERO MINING CORP
PRMW|PRIMO WTR CORP
PFG|PRINCIPAL FINANCIAL GROUP, INC
PRA|PROASSURANCE CORP
PKT|PROCERA NETWORKS, INC.
PG|PROCTER & GAMBLE COMPANY (THE)
PVTB|PRIVATEBANCORP, INC.
PGNX|PROGENICS PHARMACEUTICALS INC
PRGS|PROGRESS SOFTWARE CORPORATION
PGR|PROGRESSIVE CORPORATION (THE)
BIN|PROGRESSIVE WASTE SOLNS LTD
PLD|PROLOGIS INC
PFPT|PROOFPOINT INC
PRISB|PROMOTORA DE INFORMACIONES, S.
PRO|PROS HOLDINGS, INC.
PSEC|PROSPECT
PB|PROSPERITY BANCSHARES, INC.
PL|PROTECTIVE LIFE CORP
PLP|PROTECTIVE LIFE CORPORATION
PLPRC|PROTECTIVE LIFE CORPORATION
PRLB|PROTO LABS INC
PWX|PROVIDENCE & WORCESTOR RR
PRSC|PROVIDENCE SERVICE CORPORATION
PROV|PROVIDENT FINL HLDGS INC
PFS|PROVIDENT FINL SVCS INC
PBIP|PRUDENTIAL BANCORP INC
PRU|PRUDENTIAL FINANCIAL INC
PUK|PRUDENTIAL CORP (ADR)
PMD|PSYCHEMEDICS CORPORATION
PTGI|PTGI HOLDING INC
PEG|PUBLIC-SVC ENTERPRISE GROUP
PSA|PUBLIC STORAGE
PSAPRR|PUBLIC STORAGE
PSAPRQ|PUBLIC STORAGE
PSAPRX|PUBLIC STORAGE
PSAPRS|PUBLIC STORAGE
PSAPRT|PUBLIC STORAGE
PSAPRU|PUBLIC STORAGE
PSAPRV|PUBLIC STORAGE
PSAPRW|PUBLIC STORAGE
PUBGY|PUBLICIS GROUPE S.A.
PHM|PULTEGROUP INC.
PBYI|PUMA BIOTECHNOLOGY, INC.
PCYO|PURECYCLE CORP
PIM|PUTNAM MASTER INTERMEDIATE
QLTI|QLT INC.
QLGC|QLOGIC CORP
QADB|QAD INC
QADA|QAD INC.
QUAD|QUAD / GRAPHICS INC
KWR|QUAKER CHEMICAL CORP
PZN|PZENA INVESTMENT MANAGEMENT
QLIK|QLIK TECHNOLOGIES INC.
QEP|QEP RESOURCES, INC.
QIHU|QIHOO 360 TECHNOLOGY CO. LTD.
QIWI|QIWI PLC
QEPM|QEP MIDSTREAM PARTNERS, L.P.
QTS|QTS REALTY TRUST, INC.
QCOM|QUALCOMM INC
QLTY|QUALITY DISTRIBUTION, INC.
QSII|QUALITY SYSTEMS INC
QLYS|QUALYS INC
NX|QUANEX BUILDING PRODUCTS CORP
PWR|QUANTA SERVICES INC
QTM|QUANTUM CORPORATION
DGX|QUEST DIAGNOSTICS INCORPORATED
STR|QUESTAR CORPORATION
ZQK|QUIKSILVER INC
QDEL|QUIDEL CORP
QNST|QUINSTREET INC
Q|QUINTILES TRANSNATIONAL
QUMU|QUMU CORPORATION
CTQ|QWEST CORPORATION
CTW|QWEST CORPORATION
CTX|QWEST CORPORATION
CTU|QWEST CORPORATION
CTY|QWEST CORPORATION
RAS|RAIT FINANCIAL TRUST
RBSPRE|RBS CAPITAL FUNDING TRUST V
RBSPRI|RBS CAPITAL FUNDING TRUST VI
RBSPRG|RBS CAPITAL FUNDING TRUST VII
RCMT|RCM TECHNOLOGIES INC
RDA|RDA MICROELECTRONICS INC
RLI|RLI CORP
RLJ|RLJ LODGING TRUST
RES|RPC INC
RPM|RPM INTERNATIONAL INC
RPXC|RPX CORPORATION
RTI|RTI INTERNATIONAL METALS
RTIX|RTI SURGICAL, INC.
RFMD|RF MICRO DEVICES INC
RAX|RACKSPACE HOSTING, INC.
RDN|RADIAN GROUP INC.
ROIAK|RADIO ONE, INC.
RSYS|RADISYS CORP
RDNT|RADNET, INC.
RMBS|RAMBUS INC
RALY|RALLY SOFTWARE DEVELOPMENT COR
RL|RALPH LAUREN CORP
RPT|RAMCO-GERSHENSON PPTYS TR (MD)
RPTPRD|RAMCO-GERSHENSON PROPERTIES TR
GOLD|RANDGOLD RESOURCES LIMITED
RRC|RANGE RESOURCES CORPORATION
RPTP|RAPTOR PHARMACEUTICAL CORP
RAVN|RAVEN INDUSTRIES INC.
RJF|RAYMOND JAMES FINANCIAL INC
RJD|RAYMOND JAMES FINANCIAL, INC.
RYN|RAYONIER INC
RTN|RAYTHEON CO
ROLL|RBC BEARINGS INCORPORATED
RMAX|RE MAX HLDGS INC
RLOC|REACHLOCAL INC
RDI|READING INTERNATIONAL, INC.
RNWK|REALNETWORKS INC
RLGY|REALOGY HLDGS CORP
RP|REALPAGE INC
O|REALTY INCOME CORPORATION
OPRF|REALTY INCOME CORPORATION
RCPT|RECEPTOS, INC.
RHT|RED HAT, INC.
RLH|RED LION HOTELS CORPORATION
RRGB|RED ROBIN GOURMET BURGERS
RWT|REDWOOD TRUST INC
RBC|REGAL BELOIT CORP
RGC|REGAL ENTERTAINMENT GROUP
REG|REGENCY CTRS CORP
REGN|REGENERON PHARMACEUTICAL INC
RGS|REGIS CORP.
RM|REGIONAL MANAGEMENT CORPORATIO
RGLS|REGULUS THERAPEUTICS, INC.
RF|REGIONS FINANCIAL CORPORATION
RFPRA|REGIONS FINANCIAL CORP
RGA|REINSURANCE GROUP AMER INC
RZA|REINSURANCE GRP OF AMER
REIS|REIS INC.
RS|RELIANCE STEEL & ALUMINUM CO
RNST|RENASANT CORP.
REGI|RENEWABLE ENERGY GROUP, INC.
RGEN|REPLIGEN CORP
RCII|RENT-A-CENTER INC
RTK|RENTECH, INC.
RENT|RENTRAK CORP
REPYY|REPSOL SA - ADR
RJET|REPUBLIC AIRWAYS HOLDINGS, INC
RBCAA|REPUBLIC BANCORP INC CL-A
FRBK|REPUBLIC FIRST BANCORP, INC.
RSG|REPUBLIC SERVICES INC
REN|RESOLUTE ENERGY CORPORATION
RFP|RESOLUTE FST PRODS INC
REXI|RESOURCE AMERICA INC CL-A
RSO|RESOURCE CAPITAL CORP.
RSOPRB|RESOURCE CAPITAL CORP.
RECN|RESOURCES CONNECTION INC
MKTG|RESPONSYS INC
RH|RESTORATION HARDWARE HLDGS INC
ROIC|RETAIL OPPORTUNITY INVTS CORP
RPAI|RETAIL PPTYS AMER INC
RPAIPRA|RETAIL PROP OF AMERICA, INC.
SALE|RETAILMENOT, INC.
REV|REVLON INC
REXX|REX ENERGY CORPORATION
REX|REX AMERICAN RESOURCES CORP
REXMY|REXAM PLC
RXN|REXNORD HOLDINGS, INC
REXR|REXFORD INDL RLTY INC
RAI|REYNOLDS AMERICAN INC.
RELL|RICHARDSON ELECTRONICS LTD
RICK|RICK'S CABARET INTERNATIONAL
RIGL|RIGEL PHARMACEUTICALS INC
RNET|RIGNET, INC.
RNG|RINGCENTRAL, INC.
RIOM|RIO ALTO MNG LTD NEW
RAD|RITE AID CORP
RVBD|RIVERBED TECHNOLOGY, INC.
RVSB|RIVERVIEW BANCORP, INC.
RRTS|ROADRUNNER TRNSN SVCS HLDG INC
RHI|ROBERT HALF INTL INC
RHHBY|ROCHE HOLDING AG
RKT|ROCK-TENN CO. CL. A
ROK|ROCKWELL AUTOMATION INC
RCKB|ROCKVILLE FINANCIAL, INC.
COL|ROCKWELL COLLINS, INC.
ROC|ROCKWOOD HOLDINGS, INC.
RCKY|ROCKY BRANDS, INC.
RMCF|ROCKY MOUNTAIN CHOCOLATE
RSTI|ROFIN-SINAR TECHNOLOGIES INC
RCI|ROGERS COMMUNICATIONS INC
ROG|ROGERS CORP
ROL|ROLLINS INC.
RYCEY|ROLLS-ROYCE GROUP PLC
ROMA|ROMA FINANCIAL CORP
RTRAF|ROMARCO MINERALS INC
ROP|ROPER INDS INC (NEW)
RRMS|ROSE ROCK MIDSTREAM L P
ROSE|ROSETTA RESOURCES INC
RST|ROSETTA STONE INC
ROST|ROSS STORES,INC
ROSYY|ROSTELECOM SPON ADR
RNDY|ROUNDYS INC
RSE|ROUSE PROPERTIES, INC.
ROVI|ROVI CORPORATION
RY|ROYAL BANK OF CANADA
RGLD|ROYAL GOLD, INC.
KKPNY|KONINKLIJKE KPN N.V.
RVT|ROYCE VALUE TRUST INC
RBY|RUBICON MINERALS CORPORATION
RT|RUBY TUESDAY,INC.
RKUS|RUCKUS WIRELESS INC
RTEC|RUDOLPH TECHNOLOGIES INC
RUSHA|RUSH ENTERPISES INC
RUSHB|RUSH ENTERPRISES INC
RUTH|RUTH'S HOSPITALITY GROUP, INC.
RYAAY|RYANAIR HOLDINGS PLC ADR
R|RYDER SYSTEM INC
RYL|THE RYLAND GROUP, INC.
STBA|S&T BANCORP INC.
SBAC|SBA COMMUNICATIONS CORP
SCEPRF|SCE TRUST 1
SCEPRG|SCE TRUST II
SEIC|SEI INVESTMENTS CO
SSLT|SESA STERLITE LTD
SHFL|SHFL ENTERTAINMENT INC
SIFI|SI FINL GROUP INC MD
SJW|SJW CORP
SKM|SK TELECOM CO., LTD.
SLG|SL GREEN REALTY CORP
SLGPRI|SL GREEN REALTY CORP.
SLI|SL INDS INC
SLM|SLM CORPORATION
SM|SM ENERGY COMPANY
SPW|SPX CORPORATION
SPSC|SPS COMMERCE
SSNC|SS&C TECHNOLOGIES HLDGS INC
SSEZY|SSE PLC
STRI|STR HOLDINGS INC
SIVB|SVB FINANCIAL GROUP
SABA|SABA SOFTWARE INC.
SWS|SWS GROUP INC
SYBT|S.Y. BANCORP INC
SBMRY|SABMILLER PLC
SBRA|SABRA HEALTH CARE REIT, INC.
SFE|SAFEGUARD SCIENTIFICS INC
SAFT|SAFETY INSURANCE GROUP, INC.
SWY|SAFEWAY INC.
SAFRY|SAFRAN SA
SGA|SAGA COMMUNICATION, INC.
SGPYY|SAGE GROUP PLC
SGNT|SAGENT PHARMACEUTICALS INC.
SAIA|SAIA INC
JOE|ST. JOE COMPANY
STJ|ST JUDE MEDICAL INC
SALM|SALEM COMMUNICATIONS CL-A
CRM|SALESFORCE.COM, INC
SLXP|SALIX PHARMACEUTICALS, LTD.
SBH|SALLY BEAUTY HOLDINGS, INC.
SAXPY|SAMPO OYJ
SN|SANCHEZ ENERGY CORP
SAFM|SANDERSON FARMS INC
SNDK|SANDISK CORP
SCHYY|SANDS CHINA LTD
SAND|SANDSTORM GOLD LTD.
SASR|SANDY SPRING BANCORP INC
JBSS|SANFILIPPO JOHN & SON INC
SGMO|SANGAMO BIOSCIENCES INC
SLLDY|SANLAM LTD
SANM|SANMINA-SCI CORPORATION
SNY|SANOFI
SAPE|SAPIENT CORP.
SSL|SASOL LTD SPONS ADR
BFS|SAUL CENTERS INC
BFSPRC|SAUL CENTERS, INC.
SBRCY|SBERBANK
SCG|SCANA CORP
SCSC|SCANSOURCE INC
SGK|SCHAWK INC
HSIC|HENRY SCHEIN INC
SLB|SCHLUMBERGER LTD
SBGSY|SCHNEIDER ELECTRIC SA
SCHN|SCHNITZER STEEL INDUSTRIES,INC
SCHL|SCHOLASTIC CORPORATION
SHLM|A SCHULMAN INC
SCHW|CHARLES SCHWAB CORPORATION
FNDC|SCHWAB FUNDAMENTAL INTL
SWM|SCHWEITZER-MAUDUIT INTERNATION
SAIC|SCIENCE APPLICATIONS INTL CORP
SCLN|SCICLONE PHARMACEUTICALS INC
SGMS|SCIENTIFIC GAMES CORPORATION
SQI|SCIQUEST, INC.
SCRYY|SCOR SE
SMG|THE SCOTTS MIRACLE GRO CO
SSP|THE E.W. SCRIPPS COMPANY
SNI|SCRIPPS NETWORKS INTERACTIVE,
SEB|SEABORD CORP. MASS.
SEAC|SEACHANGE INTERNATIONAL INC
SBCF|SEACOAST BKG CORP FLA
CKH|SEACOR HOLDINGS INC.
SEE|SEALED AIR CORPORATION
SHOS|SEARS HOMETOWN AND
SGEN|SEATTLE GENETICS, INC.
SEAS|SEAWORLD ENTERTAINMENT, INC.
SOMLY|SECOM LTD (ADR)
SCSS|SELECT COMFORT CORPORATION
SIR|SELECT INCOME REIT
SEM|SELECT MEDICAL HOLDINGS CORP
SIGI|SELECTIVE INSURANCE GROUP INC
SEMG|SEMGROUP CORPORATION
SMTC|SEMTECH CORP
SRE|SEMPRA ENERGY
SENEA|SENECA FOODS CORP CL-A
SNH|SENIOR HOUSING PROPERTIES TR
SNHN|SENIOR HOUSING PROPERTIES TR
SNMX|SENOMYX, INC.
SXT|SENSIENT TECHNOLOGIES CORP
SCI|SERVICE CORP INTERNATL
NOW|SERVICENOW INC
SREV|SERVICESOURCE INTRNTNL, LLC
SVNDY|SEVEN & I HOLDINGS CO., LTD.
STRNY|SEVERN TRENT PLC
GAME|SHANDA GAMES LIMITED
SMED|SHARPS COMPLIANCE CORP.
SJR|SHAW COMMUNICATIONS INC.
SHEN|SHENANDOAH TELECOMM COMPANY
SHW|SHERWIN-WILLIAMS CO
SHLO|SHILOH INDUSTRIES INC
SHG|SHINHAN FINANCIAL GROUP
SHPG|SHIRE LIMITED
SCVL|SHOE CARNIVAL INC
SHOR|SHORETEL, INC.
SFLY|SHUTTERFLY, INC.
SSTK|SHUTTERSTOCK INC
SBGL|SIBANYE GOLD
SI|SIEMENS AKTIENGESELLSCHAFT
BSRR|SIERRA BANCORP
SWIR|SIERRA WIRELESS INC
SIF|SIFCO INDUSTRIES INC
SIAL|SIGMA-ALDRICH CORPORATION
SIGM|SIGMA DESIGNS INC
SGMA|SIGMATRON INTL INC
SBNY|SIGNATURE BANK
SIGA|SIGA TECHNOLOGIES, INC.
SLAB|SILICON LABORATORIES INC.
SLGN|SILGAN HOLDINGS INC
SIMG|SILICON IMAGE INC
SIMO|SILICON MOTION TECHNOLOGY CORP
SGI|SILICON GRAPHICS INTL CORP
SPIL|SILICONWARE PRECISION IND CO L
SBY|SILVER BAY REALTY TRUST CORP
SSRI|SILVER STANDARD RESOURCES INC
SLW|SILVER WHEATON CORP
SAMG|SILVERCREST ASSET MGMT GROUP
SVM|SILVERCORP METALS INC
SCR|SIMCERE PHARMACEUTICAL GROUP
SFNC|SIMMONS 1ST NATL CORP CL A $5
SPG|SIMON PROPERTY GROUP INC
SMPL|SIMPLICITY BANCORP INC
SSD|SIMPSON MANUFACTURING CO INC
SLP|SIMULATIONS PLUS, INC.
SBGI|SINCLAIR BROADCAST GROUP INC
SIRO|SIRONA DENTAL SYSTEMS, INC.
SIRI|SIRIUS XM HOLDINGS INC
SIX|SIX FLAGS ENTERTAINMENT CORPOR
SKX|SKECHERS USA INC CL-A
SKH|SKILLED HEALTHCARE GROUP, INC.
SKY|SKYLINE CORPORATION
SKUL|SKULLCANDY INC
SKYW|SKYWEST,INC
SWKS|SKYWORKS SOLUTIONS INC
SNN|SMITH & NEPHEW PLC
AOS|A.O. SMITH CORP (DEL)
SMSI|SMITH MICRO SOFTWARE INC
SJM|J.M. SMUCKER CO.
SNA|SNAP-ON INC
LNCE|SNYDERS-LANCE IN
SQM|SOCIEDAD QUIMICA MINERAL DE
SCGLY|SOCIETE GENERALE S.A. (ADR)
SFTBY|SOFTBANK CORP.
SLRC|SOLAR CAPITAL LTD.
SUNS|SOLAR SENIOR CAPITAL LTD.
SLH|SOLERA HOLDINGS INC
SLTM|SOLTA MEDICAL, INC
SONC|SONIC CORPORATION
SAH|SONIC AUTOMOTIVE INC CLASS A
SON|SONOCO PRODUCTS CO
SNE|SONY CORPORATION
SONVY|SONOVA HOLDING AG (THE)
BID|SOTHEBY'S
SONS|SONUS NETWORKS INC.
SOHO|SOTHERLY HOTELS INC
SFUN|SOUFUN HLDGS LTD
SJI|SOUTH JERSEY INDUSTRIES
SXE|SOUTHCROSS ENERGY PARTNERS, L.
SO|THE SOUTHERN CO.
SCCO|SOUTHERN COPPER CORPORATION
SBSI|SOUTHSIDE BANCSHARES INC
LUV|SOUTHWEST AIRLINES CO
OKSB|SOUTHWEST BANCORP INC/OKLA
SWX|SOUTHWEST GAS CORP
SWN|SOUTHWESTERN ENERGY CO.
SSS|SOVRAN SELF STORAGE,INC.
SPAN|SPAN-AMERICA MED SYS INC
SBSA|SPANISH BROADCASTING SYS INC
CODE|SPANSION INC.
LOV|SPARK NETWORKS, INC.
SPAR|SPARTAN MOTORS INC.
SPTN|SPARTAN STORES INC
SPA|SPARTON CORP
SE|SPECTRA ENERGY CORP
SPNC|SPECTRANETICS CORP
SPPI|SPECTRUM PHARMACEUTICALS INC
SPGZ|SPECTRUM GROUP INTL INC
SPB|SPECTRUM BRANDS HOLDINGS INC
SPDC|Speed Commerce Inc
TRK|SPEEDWAY MOTORSPORTS INC
SPR|SPIRIT AEROSYSTEMS
SAVE|SPIRIT AIRLINES, INC.
SRC|SPIRIT REALTY CAPITAL, INC.
SPLK|SPLUNK INC
SPRD|SPREADTRUM COMMUNICATIONS INC.
LEAF|SPRINGLEAF HOLDINGS INC
S|SPRINT CORPORATION
SFM|SPROUTS FMRS MKT INC
STAA|STAAR SURGICAL CO NEW
SSI|STAGE STORES INC
STAG|STAG INDUSTRIAL, INC.
STAGPRA|STAG INDUSTRIAL INC
STMP|STAMPS COM INC
SFG|STANCORP FINANCIAL CORP, INC.
SMP|STND MOTOR PROD INC CL-A
SPF|STANDARD PACIFIC CORP NEW
STAN|STANDARD PARKING CORPORATION
SXI|STANDEX INTERNATL CORP
STLY|STANLEY FURNITURE INC (NEW)
SWK|STANLEY BLACK & DECKER INC
SWU|STANLEY BLACK & DECKER, INC.
SWJ|STANLEY BLACK & DECKER, INC.
STN|STANTEC INCORPORATED
SPLS|STAPLES, INC.
SGU|STAR GAS PARTNERS, L.P.
SBUX|STARBUCKS CORP.
SCX|L S STARRETT CO CL-A COM
SRT|STARTEC INCORPORATED
STFC|STATE AUTO FINANCIAL CORP
STWD|STARWOOD PROPERTY TRUST INC.
STRZA|STARZ
HOT|STARWOOD HOTELS & RESORTS
STBZ|STATE BANK FINANCIAL CORP
STT|STATE STREET CORPORATION (NEW)
STO|STATOILHYDRO ASA
STLD|STEEL DYNAMICS, INC.
SXCL|STEEL EXCEL INC
SCS|STEELCASE INC.
SMRT|STEIN MART INC
STEL|STELLARONE CORPORATION
SCL|STEPAN CO
STML|STEMLINE THERAPEUTICS INC
SRCL|STERICYCLE INC
STE|STERIS CORP
STL|STERLING BANCORP
STRL|STERLING CONSTRUCTION CO INC
STSA|STERLING FINANCIAL CORPORATION
STEI|STEWART ENTERPRISES INC
STC|STEWART INFORMATION SVCS CORP
SF|STIFEL FINANCIAL CORP
SWC|STILLWATER MINING COMPANY
STCK|STOCK BUILDING SUPPLY HOLDINGS
SGY|STONE ENERGY CORP
SRI|STONERIDGE, INC.
STRP|STRAIGHT PATH COMMUNICATIONS I
BEE|STRATEGIC HOTELS & RESORTS INC
STRT|STRATTEC SEC CORP
STRS|STRATUS PPTYS INC
STRM|STREAMLINE HEALTH SOLUTNS, INC
SYK|STRYKER CORP
STB|STUDENT TRANSPORTATION INC
SPH|SUBURBAN PROPANE PARTNERS, LP
SUBK|SUFFOLK BANCORP
SCMP|SUCAMPO PHARMACEUTICALS INC
SSUMY|SUMITOMO CORPORATION
SUTNY|SUMITOMO MITSUI TRUST HOLDINGS
INN|SUMMIT HOTEL PROPERTIES, INC.
INNPRB|SUMMIT HOTEL PROPERTIES, INC.
SMLP|SUMMIT MIDSTREAM PARTNERS LP
SNBC|SUN BANCORP INC (N.J.)
SUI|SUN COMMUNITIES INC
SUIPRA|SUN COMMUNITIES, INC.
SLF|SUN LIFE FINANCIAL INC
SNHY|SUN HYDRAULICS INC
SU|SUNCOR ENERGY INC.
SXC|SUNCOKE ENERGY INC
SNSS|SUNESIS PHARMACEUTICALS INC
SUNE|SUNEDISON, INC
SXL|SUNOCO LOGISTICS PARTNERS LP
STKL|SUNOPTA INC
SHO|SUNSTONE HOTEL INVESTORS INC.
STI|SUNTRUST BANKS INC $1.00 PAR
STIPRE|SUNTRUST BANKS, INC.
SMCI|SUPER MICRO COMPUTER, INC.
SPN|SUPERIOR ENERGY SERVICES INC
SUP|SUPERIOR INDS INTL INC
SUPX|SUPERTEX INC
SVU|SUPERVALU INC
SPRT|SUPPORT.COM INC
STS|SUPREME INDUSTRIES INC
SGTPY|SURGUTNEFTEGAZ SPON ADR PREF
SGTZY|OAO SURGUTNEFTEGAZ
SRDX|SURMODICS INC
SUSQ|SUSQUEHANNA BANCSHARES
SUSS|SUSSER HOLDINGS CORPORATION
SUSP|SUSSER PETROLUM PARTNRS LP
SVCBY|SVENSKA CELLULOSA AB SPON ADR
SVNLY|SVENSKA HANDELSBANKEN AB
SWSH|SWISHER HYGIENE INC
SWZ|SWISS HELVETIA FUND INC
SCMWY|SWISSCOM
SYKE|SYKES ENTERPRISES INC
SYMC|SYMANTEC CORP
SYA|SYMETRA FINANCIAL CORPORATION
SMA|SYMMETRY MEDICAL INC.
SYNL|SYNALLOY CORP.
SNCR|SYNCHRONOSS TECHNOLOGIES INC.
SYNA|SYNAPTICS, INC.
GEVA|SYNAGEVA BIOPHARMA CORP
SNPS|SYNOPSYS INC
SYT|SYNGENTA AG
SURG|SYNERGETICS USA, INC.
SNV|SYNOVUS FINANCIAL CORPORATION
SNVPRC|SYNOVUS FINANCIAL CORP
SYNT|SYNTEL INC
SNX|SYNNEX CORPORATION
SGYP|SYNERGY PHARMACEUTICALS INC
SYUT|SYNUTRA INTL INC
SYRG|SYNERGY RESOURCES CORPORATION
SYPR|SYPRIS SOLUTIONS INC (DE)
SYY|SYSCO CORPORATION
SSMXY|SYSMEX CORP
SYX|SYSTEMAX INC
TCB|TCF FINANCIAL CORP
TCBPRB|TCF FINANCIAL CORPORATION
TCP|TC PIPELINES, L.P.
AMTD|TD AMERITRADE HOLDING CORP
TE|TECO ENERGY INC.
TESS|TESSCO TECHNOLOGIES INC
TCPC|TCP CAP CORP
TFSL|TFS FINANCIAL CORPORATION
TGE|TGC INDUSTRIES INC
TCRD|THL CREDIT INC
TICC|TICC CAPITAL CORP.
TJX|TJX COMPANIES INC (NEW)
TRR|TRC COS INC
TRW|TRW AUTOMOTIVE HOLDINGS CORP.
TTMI|TTM TECHNOLOGIES  INC
TWTC|TW TELECOM INC.
DATA|TABLEAU SOFTWARE, INC.
TAHO|TAHOE RESOURCES, INC.
TWN|TAIWAN FUND INC
TSM|TAIWAN SEMICONDUCTOR MFG ADS
TTWO|TAKE TWO INTERACTIVE SOFTWARE
XRS|TAL ED GROUP
TAL|TAL INTERNATIONAL GROUP, INC.
TLM|TALISMAN ENERGY INC.
TEP|TALLGRASS ENERGY PARTNERS, LP
TAM|TAMINCO CORP
TLF|TANDY LEATHER FACTORY INC
SKT|TANGER FACTORY OUTLET CENTERS
TNGO|TANGOE INC
TRGT|TARGACEPT, INC.
NGLS|TARGA RESOURCES PARTNERS LP
TGT|TARGET CORPORATION
TRGP|TARGA RESOURCES CORP.
TGB|TASEKO MINES LIMITED
TASR|TASER INTERNATIONAL, INC.
TTM|TATA MOTORS LIMITED
TCO|TAUBMAN CENTERS INC
TCOPRJ|TAUBMAN CENTERS, INC.
TCOPRK|TAUBMAN CENTERS, INC.
TAYC|TAYLOR CAP GROUP, INC.
TAYCO|TAYLOR CAPITAL GROUP, INC.
TMHC|TAYLOR MORRISON HOME CORP.
TISI|TEAM, INC.
TMH|TEAM HEALTH HOLDINGS INC
TECD|TECH DATA CORP
TECH|TECHNE CORP
TCK|TECK RESOURCES LIMITED
TTGT|TECHTARGET, INC.
TECUB|TECUMSEH PRODUCTS CO
TECUA|TECUMSEH PRODUCTS CO CL-A
TRC|TEJON RANCH CO
TKMR|TEKMIRA PHARMACEUTICALS CORP
TEO|TELECOM ARGENTINA S.A.
TI|TELECOM ITALIA SPA
TIA|TELECOM ITALIA SPA
TSYS|TELECOMMUNICATION SYSTEMS INC
TDY|TELEDYNE TECHNOLOGIES INC
TFX|TELEFLEX INC.
VIV|TELECOMUNICACOES DE SAO PAULO
TEF|TELEFONICA S.A. ADR
TDS|TELEPHONE AND DATA SYS INC
TDJ|TELEPHONE AND DATA SYSTEMS
TDE|TELEPHONE AND DATA SYSTEMS INC
TELNY|TELENOR ASA
TNAV|TELENAV INC
TLAB|TELLABS INC.
TLSYY|TELSTRA CORP ADR (FINAL)
TU|TELUS CORPORATION
TTEC|TELETECH HOLDINGS INC
TDF|TEMPLETON DRAGON
EMF|TEMPLETON EMERGING MKTS FD INC
GIM|TEMPLETON GLOBAL INCOME FUND
TRF|TEMPLETON RUSSIA AND EAST
TPX|TEMPUR SEALY INTERNATIONAL INC
TS|TENARIS SA
TCEHY|TENCENT HOLDINGS LIMITED
THC|TENET HEALTHCARE CORP
TNC|TENNANT CO
TEN|TENNECO INC
TDC|TERADATA CORPORATION
TER|TERADYNE INC
TEX|TEREX CORP (NEW)
TEZNY|TERNA RETE ELETTRICA NAZIONALE
TX|TERNIUM SA
TBNK|TERRITORIAL BANCORP INC.
TRNO|TERRENO REALTY CORPORATION
TSRO|TESARO INC
TSCDY|TESCO PLC (SPONSORED) ADR
TESO|TESCO CORPORATION
TSO|TESORO CORPORATION
TEVA|TEVA PHARMACEUTICAL IND LTD
TTEK|TETRA TECH INC (NEW)
TSRA|TESSERA TECHNOLOGIES, INC.
TTPH|TETRAPHASE PHARMACEUTICALS INC
TCBI|TEXAS CAPITAL BANCSHARES, INC.
TXI|TEXAS INDUSTRIES INC
TXN|TEXAS INSTRUMENTS INC.
TPL|TEX.PAC.LAND TR.SUB.CTF.
TXRH|TEXAS ROADHOUSE, INC.
TTF|THAI FD INC
TXT|TEXTRON INC.DEL.
TXTR|TEXTURA CORPORATION
TGTX|TG THERAPEUTICS INC
THRX|THERAVANCE, INC.
TMO|THERMO FISHER SCIENTIFIC INC
THR|THERMON GROUP HOLDINGS, INC.
TST|THESTREET INC
TPGI|THOMAS PROPERTIES GROUP, INC.
TC|THOMPSON CREEK METALS COMPANY
TCPRT|THOMPSON CREEK METALS CO INC
TRI|THOMSON REUTERS CORPORATION
THO|THOR INDUSTRIES INC
THOR|THORATEC CORPORATION
MMM|3M COMPANY
THLD|THRESHOLD PHARMACEUTICALS, INC
TIBX|TIBCO SOFTWARE INC.
TDW|TIDEWATER INC
TIF|TIFFANY & CO
TLYS|TILLY'S, INC.
THI|TIM HORTONS INC.
TSU|TIM PARTICIPACOES S.A.
TSBK|TIMBERLAND BANCORP INC
TWX|TIME WARNER INC.
TWC|TIME WARNER CABLE INC.
TKR|TIMKEN CO
TGD|TIMMINS GOLD CORP
TWI|TITAN INTERNATIONAL INC (NEW)
TIVO|TIVO INC
TOL|TOLL BROTHERS, INC.
TMP|TOMPKINS FINANCIAL CORPORATION
TR|TOOTSIE ROLL & IND.
TMK|TORCHMARK CORP
TTC|TORO CO (DELAWARE)
TD|TORONTO DOMINION BANK
TOT|TOTAL SA
TOWR|TOWER INTERNATIONAL, INC.
TW|TOWERS WATSON & CO
TSS|TOTAL SYS SVC INC.
TWER|TOWERSTREAM CORPORATION
CLUB|TOWN SPORTS INTNL HOLDGS, INC.
TOWN|TOWNEBANK PORTSMOUTH VA
TM|TOYOTA MOTOR CORPORATION
TSCO|TRACTOR SUPPLY CO
TBLEY|TRACTEBEL ENERGIA SA
TACT|TRANSACT TECHNOLOGIES INC
TWMC|TRANSWORLD ENTERTAINMENT CORP
TAC|TRANSALTA CORPORATION
TRNS|TRANSCAT, INC.
TRP|TRANSCANADA CORP
TSPT|TRANSCEPT PHARMACEUTICALS INC
TDG|TRANSDIGM GROUP INCORPORATED
TGA|TRANSGLOBE ENERGY CORPORATION
TA|TRAVELCENTERS OF AMERICA LLC
TANN|TRAVELCENTERS OF AMERICA LLC
TRV|THE TRAVELERS COMPANIES, INC
TZOO|TRAVELZOO INC
TG|TREDEGAR CORPORATION
TSRYY|TREASURY WINE ESTATES AUSTRALI
TREE|TREE.COM, INC.
THS|TREEHOUSE FOODS, INC.
TREX|TREX COMPANY INC
TCAP|TRIANGLE CAPITAL CORPORATION
TPLM|TRIANGLE PETROLEUM CORPORATION
TRBNW|TRIBUNE COMPANY
TRBAA|TRIBUNE COMPANY
TCBK|TRICO BANCSHARES
TRS|TRIMAS CORPORATION
TRMB|TRIMBLE NAVIGATION LTD
TRIB|TRINITY BIOTECH PLC
TRN|TRINITY INDUSTRIES INC (DEL)
TPHS|TRINITY PLACE HOLDINGS INC
GTS|TRIPLE-S MANAGEMENT CORP
TQNT|TRIQUINT SEMICONDUCTOR INC
TSC|TRISTATE CAPITAL HOLDINGS, INC
TGI|TRIUMPH GROUP INC
TRIP|TRIPADVISOR, INC.
TPCA|TROPICANA ENTERTAINMENT INC.
TBI|TRUEBLUE, INC.
TRLA|TRULIA INC
TRST|TRUSTCO BANK CORP NY
TRMK|TRUSTMARK CORPORATION
TUES|TUESDAY MORNING CORP
TUMI|TUMI HOLDINGS, INC.
TUP|TUPPERWARE BRANDS CORPORATION
TKC|TURKCELL ILETISIM HIZMETLERI
TKGBY|TURKIYE GARANTI BANKASI AS
TPC|TUTOR PERINI CORPORATION
FOXA|TWENTY-FIRST CENTURY FOX, INC.
FOX|TWENTY-FIRST CENTURY FOX, INC.
VNET|21VIANET GROUP, INC.
TWIN|TWIN DISC INCORPORATED
TWO|TWO HARBORS INVESTMENT CORP.
IIVI|II-VI INC
TYL|TYLER TECHNOLOGIES INC
TSN|TYSON FOODS INC CL-A
UDR|UDR INC
UCP|UCP INC
UFPT|UFP TECHNOLOGIES INC
UGI|UGI CORPORATION (HOLDING CO)
UIL|UIL HOLDINGS CORPORATION
UMBF|UMB FINANCIAL CORP
USAC|USA COMPRESSION PARTNERS LP
USAK|USA TRUCK INC
USB|U.S. BANCORP
USBPRN|U.S. BANCORP
USBPRM|U.S. BANCORP
USBPRA|U.S. BANCORP
UMH|UMH PROPERTIES, INC.
UNS|UNS ENERGY CORPORATION
URS|URS CORPORATION
USNA|USANA HEALTH SCIENCES INC
USG|USG CORP (NEW)
USCR|U.S. CONCRETE INC
USPH|U.S. PHYSICAL THERAPY, INC.
USMO|USA MOBILITY INC
PRTS|U.S. AUTO PARTS NETWORK, INC.
ULTA|ULTA SALON COSMETICS & FRAGRAN
ULTI|ULTIMATE SOFTWARE GROUP INC
UCTT|ULTRA CLEAN HOLDINGS, INC.
ULBI|ULTRALIFE CORPORATION
UGP|ULTRAPAR PARTICIPACOES S.A.
UTEK|ULTRATECH INC
UMPQ|UMPQUA HLDGS CORP
UA|UNDER ARMOUR, INC.
UNICY|UNICHARM CORP.
UFI|UNIFI INC.
UNF|UNIFIRST CORPORATION
UL|UNILEVER PLC (NEW)
UN|UNILEVER N.V. NY SHS (NEW)
UBSH|UNION FIRST MARKET BANKSHARES
UNP|UNION PACIFIC CORP.
UIS|UNISYS CORPORATION
UNT|UNIT CORP
UBMI|UNITED BANCORP INC MICH
UCFC|UNITED COMMUNITY FINANCIAL
UCBI|UNITED COMMUNITY BANKS INC
UCBA|UNITED CMNTY BANCORP IND
UBSI|UNITED BANKSHARES INC W V
UAL|UNITED CONTINENTAL HOLDING INC
UBNK|UNITED FINANCIAL BANCORP, INC.
UFCS|UNITED FIRE GROUP INC
UIHC|UNITED INSURANCE HOLDINGS CORP
UMC|UNITED MICROELECTRONICS
UNFI|UNITED NATURAL FOODS INC
UOVEY|UNITED OVERSEAS BK LTD
UPS|UNITED PARCEL SERVICE, INC.
URI|UNITED RENTALS, INC.
USM|UNITED STATES CELLULAR CORPORA
UZA|UNITED STATES CELLULAR CORP
USEG|U S ENERGY CORP - WYOMING
USLM|UNITED STATES LIME & MINERALS
USTR|UNITED STATIONERS INC
UTX|UNITED TECHNOLOGIES CORP
UTXPRA|UNITED TECHNOLOGIES CORP
UTHR|UNITED THERAPEUTICS CORP
UUGRY|UNITED UTILITIES GROUP PLC
UNH|UNITEDHEALTH GROUP INCORPORATE
UTL|UNITIL CORPORATION
UAM|UNIVERSAL AMERICAN CORP.
UVV|UNIVERSAL CORPORATION
OLED|UNIVERSAL DISPLAY CORPORATION
UEIC|UNIVERSAL ELECTRS INC
UFPI|UNIVERSAL FOREST PRODUCTS INC
UHT|UNIVERSAL HEALTH RLTY INCM SBI
UVE|UNIVERSAL INS HLDGS INC
USAP|UNIVERSAL STAINLESS & ALLOY
UACL|UNIVERSAL TRUCKLOAD SVCS INC.
UHS|UNIVERSAL HEALTH SVC CL B
UTI|UNIVERSAL TECHNICAL INSTITUTE
UVSP|UNIVEST CORP OF PENNSYLVANIA
UNM|UNUM GROUP
UPIP|UNWIRED PLANET INC
UEC|URANIUM ENERGY CORP
URBN|URBAN OUTFITTERS INC
UPI|UROPLASTY, INC.
UBP|URSTADT BIDDLE PROPERTIES
UBA|URSTADT BIDDLE PROPERTIES INC.
UBPPRF|URSTADT BIDDLE PROPERTIES INC.
USNZY|USINAS SIDERURGICAS DE MINAS
ECOL|US ECOLOGY INC
UTMD|UTAH MEDICAL PRODS INC.
WOOF|VCA ANTECH, INC.
VFC|VF CORP
VSEC|VSE CORP
VOXX|INTERNATIONAL CORP
EGY|VAALCO ENERGY, INC.
MTN|VAIL RESORTS, INC.
VHI|VALHI INC
VRX|VALEANT PHARMACEUTICALS INTL
VALEP|VALE SA
VLEEY|VALEO SPONS ADR
VLO|VALERO ENERGY CORPORATION
VLY|VALLEY NATIONAL BANCORP
VMI|VALMONT INDUSTRIES INC
VAL|VALSPAR CORP
VALU|VALUE LINE INC
VCLK|VALUECLICK INC
VVTV|VALUEVISION MEDIA INC
VSB|VANTAGESOUTH BANCSHARES INC
VNTV|VANTIV, INC.
VAR|VARIAN MEDICAL SYSTEMS INC
VDSI|VASCO DATA SEC INTL
VASC|VASCULAR SOLUTIONS INC
VVC|VECTREN CORP
VGR|VECTOR GROUP LTD
VECO|VEECO INSTRUMENTS INC
VEEV|VEEVA SYSTEMS INC
VTR|VENTAS, INC.
VTUS|VENTRUS BIOSCIENCES, INC.
VOO|VANGUARD INDEX FUNDS
VE|VEOLIA ENVIRONNEMENT
VRA|VERA BRADLEY, INC.
VSTM|VERASTEM, INC.
PAY|VERIFONE SYSTEMS INC
VRSN|VERISIGN INC
VZ|VERIZON COMMUNICATIONS INC.
VRNT|VERINT SYSTEMS, INC.
VRSK|VERISK ANALYTICS INC.
VET|VERMILION ENERGY INC
VSR|VERSAR INC
VRTX|VERTEX PHARMACEUTICALS INC
VVI|VIAD CORP
VSAT|VIASAT INC
VIAS|VIASYSTEMS GROUP, INC.
VIA|VIACOM INC
VIAB|VIACOM INC
VICL|VICAL INC
VICR|VICOR CORP
VPFG|VIEWPOINT FINANCIAL GROUP
VLGEA|VILLAGE SUPERMKT INC CL-A(NEW)
VCISY|VINCI
VCBI|VIRGINIA COMM BANCORP INC
VHC|VIRNETX HOLDING CORPORATION
V|VISA INC.
VRTU|VIRTUSA CORPORATION
VRTS|VIRTUS INVESTMENT PARTNERS, IN
VSH|VISHAY INTERTECHNOLOGY
VPG|VISHAY PRECISION GROUP INC
VSTOW|WTS/VISTEON CORPORATION
VC|VISTEON CORPORATION
VTSS|VITESSE SEMICONDUCTOR CORP
VSI|VITAMIN SHOPPE, INC.
VIVHY|VIVENDI
VMW|VMWARE INC.
VCRA|VOCERA COMMUNICATIONS, INC.
VOD|VODAFONE GROUP PLC
VOCS|VOCUS, INC.
VOLC|VOLCANO CORPORATION
VLKAY|VOLKSWAGEN AKTIENGESELLSCHAFT
VISI|VOLT INFO SCIENCES, INC.
VG|VONAGE HOLDINGS CORP.
WILN|WI-LAN INC
VNO|VORNADO REALTY TRUST
VNOPRL|VORNADO REALTY TRUST
VNOPRK|VORNADO REALTY TRUST
VNOPRJ|VORNADO REALTY TRUST
VNOD|VORNADO REALTY L.P.
VMC|VULCAN MATERIALS CO
WTI|W&T OFFSHORE, INC
WDFC|WD 40 CO
WCIC|WCI COMMUNITIES, INC.
WGL|WGL HLDGS INC
WBC|WABCO HOLDINGS INC.
WSFS|WSFS FINANCIAL CORP
WX|WUXI PHARMATECH (CAYMAN) INC.
WMIH|WMI HOLDINGS CORP
WPPGY|WPP PLC
WNC|WABASH NATIONAL CORP.
WAB|WABTEC CORP
WDR|WADDELL & REED FIN., INC.
WAGE|WAGEWORKS INC
WMT|WAL MART STORES INC
WAG|WALGREEN CO.
WD|WALKER & DUNLOP, INC.
WAC|WALTER INVESTMENT MGMT CORP
WRES|WARREN RESOURCES INC.
WBCO|WASHINGTON BANKING CO
WAFD|WASHINGTON FEDERAL INC
WPO|WASHINGTON POST CO CL B
WRE|WASHINGTON REAL ESTATE INVT TR
WASH|WASHINGTON TR BANCORP INC
WCN|WASTE CONNECTIONS INC
WM|WASTE MANAGEMENT INC
WAT|WATERS CORPORATION
WSBF|WATERSTONE FINANCIAL, INC.
WSO|WATSCO INC
WTS|WATTS WATER TECHNOLOGIES INC
WPP|WAUSAU PAPER CORP
WWWW|WEB.COM GROUP, INC
WBMD|WEBMD HEALTH CORP.
WBS|WEBSTER FINANCIAL CORP
WEICY|WEICHAI POWER CO. LTD
WRI|WEINGARTEN REALTY INVS (SBI)
WMK|WEIS MARKETS INC.
WCG|WELLCARE HEALTH PLANS INC
WLP|WELLPOINT, INC.
WFC|WELLS FARGO & CO (NEW)
WFCPRQ|WELLS FARGO & COMPANY
WFCPRL|WELLS FARGO & COMPANY
WFCPRJ|WELLS FARGO & COMPANY
EOD|WELLS FARGO ADVANTAGE GLOBAL D
ERC|EVERGREEN MULTI-SECTOR
WEN|WENDY'S CO/THE
WERN|WERNER ENTERPRISES INC
WSBC|WESBANCO INC
WAIR|WESCO AIRCRAFT HOLDINGS, INC.
WCC|WESCO INTERNATIONAL INC.
WTBA|WEST BANCORPORATION INC
WSTC|WEST CORPORATION
WMAR|WEST MARINE INC
WST|WEST PHARMACEUTICAL SERVICES
WABC|WESTAMERICA BANCORP
WR|WESTAR ENERGY, INC.
WBB|WESTBURY BANCORP INC
WSTL|WESTELL TECHNOLOGIES INC
WAL|WESTERN ALLIANCE BANCORP
WDC|WESTERN DIGITAL CORPORATION
WES|WESTERN GAS PARTNERS, LP
WGP|WESTERN GAS EQUITY PARTNERS LP
WNR|WESTERN REFINING, INC.
WNRL|WESTERN REFINING LOGISTICS, LP
WU|WESTERN UNION COMPANY (THE)
WFD|WESTFIELD FINANCIAL, INC.
WLK|WESTLAKE CHEMICAL CORPORATION
WLB|WESTMORELAND COAL COMPANY
WPRT|WESTPORT INNOVATIONS INC
WBK|WESTPAC BANKING CORP ADS
WHG|WESTWOOD HOLDINGS GROUP, INC.
WTSL|WET SEAL INC CL-A
WEX|WEX INC
WEYS|WEYCO GROUP INC
WY|WEYERHAEUSER COMPANY
WYPRA|WEYERHAEUSER COMPANY
WHR|WHIRLPOOL CORP.
WSR|WHITESTONE REIT
WWAV|WHITEWAVE FOODS COMPANY
WLL|WHITING PETROLEUM CORPORATION
WHZ|WHITING USA TR II
WFM|WHOLE FOODS MARKET INC
JWA|WILEY JOHN & SONS CL-A
WG|WILLBROS GROUP, INC
WMB|THE WILLIAMS COMPANIES, INC.
CWEI|CLAYTON WILLIAMS ENERGY, INC
WPZ|WILLIAMS PARTNERS L. P.
WSM|WILLIAMS-SONOMA, INC.
WLFC|WILLIS LEASE FINANCE CORP
WIBC|WILSHIRE BANCORP INC
WINA|WINMARK CORP
WGO|WINNEBAGO INDUSTRIES INC
FUR|WINTHROP REALTY TRUST
WTFC|WINTRUST FINANCIAL CORP
WEC|WISCONSIN ENERGY CORP(HLDG CO)
WETF|WISDOMTREE INVESTMENTS, INC.
WOSYY|WOLSELEY PLC
WWW|WOLVERINE WORLD WIDE
WOPEY|WOODSIDE PETROLEUM SPONS ADR
WWD|WOODWARD INC
WDAY|WORKDAY, INC.
WRLD|WORLD ACCEP CORP DEL
INT|WORLD FUEL SERVICES CORP
WWE|WORLD WRESTLING ENTERTAINMENT
WOR|WORTHINGTON INDUSTRIES
WPX|WPX ENERGY, INC.
WMGI|WRIGHT MED GROUP INC
WYN|WYNDHAM WORLDWIDE CORP.
WYNN|WYNN RESORTS, LIMITED
XOXO|XO GROUP INC
XEL|XCEL ENERGY INC
XLNX|XILINX INCORPORATED
XNPT|XENOPORT INC
XRX|XEROX CORPORATION
XRM|XERIUM TECHNOLOGIES INC
XIN|XINYUAN REAL ESTATE LTD
XOMA|XOMA CORP DEL
XYL|XYLEM INC.
XOOM|XOOM CORP
YPF|YPF SOCIEDAD ANONIMA
YDKN|YADKIN FINANCIAL CORP
YHOO|YAHOO INC
YAHOY|YAHOO JAPAN CORPORATION
AUY|YAMANA GOLD INC
YZC|YANZHOU COAL MINING CO. LTD
YARIY|YARA INTERNATIONAL ASA
YELP|YELP INC.
YONG|YONGYE INTERNATIONAL INC
YORW|YORK WATER CO
YUM|YUM BRANDS, INC.
ZAGG|ZAGG INCORPORATED
ZLC|ZALE CORP (NEW)
ZFC|ZAIS FINL CORP
ZBRA|ZEBRA TECHNOLOGIES INC
ZLTQ|ZELTIQ AESTHETICS INC
ZEP|ZEP INC.
ZHNE|ZHONE TECHNOLOGIES INC NEW
ZMH|ZIMMER HLDGS INC
ZION|ZIONS BANCORP
ZIONW|WTS/ZIONS BANCORPORATION
ZIXI|ZIX CORPORATION
ZOLT|ZOLTEK COS INC
ZTS|ZOETIS INC.
ZUMZ|ZUMIEZ INC.
ZURVY|ZURICH INS GROUP LTD
ZTR|ZWEIG TOTAL RETURN FD INC
ZIGO|ZYGO CORPORATION
ZNGA|ZYNGA INC.
DDAIF|DAIMLER AG
SANPRE|SANTANDER FINANCE PFD, S.A. UN
ACT|ACTAVIS PLC
AYR|AIRCASTLE LIMITED
ALKS|ALKERMES PLC
DOX|AMDOCS LIMITED
ANFI|AMIRA NATURE FOODS LTD
AMBA|AMBARELLA INC
AON|AON PLC
ACGL|ARCH CAPITAL GROUP LTD.
ARHPRC|ARCH CAPITAL GROUP LTD.
AGII|ARGO GROUP INTL HOLDINGS LTD
APAGF|APCO OIL & GAS INTL INC
ARMHF|ARM HOLDINGS PLC
AHL|ASPEN INSURANCE HOLDINGS LTD
AHLPRB|ASPEN INSURANCE HOLDINGS LTD
AHLPRC|ASPEN INSURANCE HOLDINGS LMTD
AGO|ASSURED GUARANTY LTD.
AFH|ATLAS FINANCIAL HOLDINGS INC.
AXS|AXIS CAPITAL HOLDINGS, LTD.
AXSPRD|AXIS CAPITAL HOLDINGS, LTD.
AXSPRC|AXIS CAPITAL HOLDINGS, LTD.
EXXI|ENERGY XXI (BERMUDA) LTD
ACN|ACCENTURE PLC
BIP|BROOKFIELD INFRASTRUCTURE PART
BEP|BROOKFIELD RENEWABLE ENERGY
BG|BUNGE LIMITED.
CYD|CHINA YUCHAI INTL LTD
IMOS|CHIPMOS TECH BERMUDA LTD
CENJF|COASTAL ENERGY COMPANY
CWCO|CONSOLIDATED WATER CO INC
BAP|CREDICORP LTD.
CZZ|COSAN LIMITED
COV|COVIDIEN PUBLIC LIMITED COMPAN
DLPH|DELPHI AUTOMOTIVE PLC
ETN|EATON CORP PLC
ENH|ENDURANCE SPECIALTY HLDGS LTD
ENHPRB|ENDURANCE SPECIALTY HLDG LTD
ESGR|ENSTAR GROUP LTD
ASA|ASA  GOLD AND PRECIOUS
ESV|ENSCO PLC
RE|EVEREST RE GROUP LTD
FN|FABRINET
FLTX|FLEETMATICS GROUP PLC
FDP|FRESH DEL MONTE PRODUCE INC.
FSL|FREESCALE SEMICONDUCTOR LTD
GLOG|GASLOG LTD
G|GENPACT LIMITED
GSOL|GLOBAL SOURCES LIMITED
GBLI|GLOBAL INDEMNITY PLC
HELE|HELEN OF TROY LTD (NEW)
HOLI|HOLLYSYS AUTOMATION TECH LTD
ICLR|ICON PUBLIC LIMITED COMPANY
IR|INGERSOLL-RAND PLC
IVZ|INVESCO LTD.
JAZZ|JAZZ PHARMACEUTICALS PLC
VLCCF|KNIGHTSBRIDGE TANKERS, LTD.
KOS|KOSMOS ENERGY LTD.
LAZ|LAZARD LTD
LBTYA|LIBERTY GLOBAL, PLC
LBTYK|LIBERTY GLOBAL, PLC.
LXFT|LUXOFT HLDG INC
MHLD|MAIDEN HOLDINGS, LTD.
MHPRA|MAIDEN HOLDINGS, LTD.
MHLDO|MAIDEN HOLDINGS, LTD.
MANU|MANCHESTER UTD PLC NEW
MNK|MALLINCKRODT PUBLIC LIMITED CO
MRVL|MARVELL TECHNOLOGY GROUP LTD.
KORS|MICHAEL KORS HOLDINGS LIMITED
MONT|MONTAGE TECHNOLOGY GROUP LIMIT
MRH|MONTPELIER RE HOLDINGS LTD.
MRHPRA|MONTPELIER RE HOLDINGS, LTD.
AOSL|ALPHA & OMEGA SEMICONDUCTOR, L
NBR|NABORS INDUSTRIES LTD.
HLSS|HOME LN SERVICING SOLUTIONS LT
NCLH|NORWEGIAN CRUISE LINE HLDG LTD
OB|ONEBEACON INSURANCE GROUP LTD
OEH|ORIENT-EXPRESS HOTELS LTD
PRE|PARTNERRE LTD BERMUDA
PREPRF|PARTNERRE LTD.
PREPRE|PARTNERRE LTD.
PTP|PLATINUM UNDERWRITERS HLDGS
PRSG|PRIMUS GUARANTY, LTD.
PRTA|PROTHENA CORP PLC
RNR|RENAISSANCE RE HOLDINGS LTD
RNRPRE|RENAISSANCERE HOLDINGS LTD.
RDC|ROWAN COMPANIES PLC
SDRL|SEADRILL LTD.
STX|SEAGATE TECHNOLOGY PLC
SFL|SHIP FINANCE INTERNATIONAL LTD
SIG|SIGNET JEWELERS LIMITED
SINA|SINA CORPORATION
UTIW|UTI WORLDWIDE
TNP|TSAKOS ENERGY NAVIGATION LTD
TNPPRC|TSAKOS ENERGY NAVIGATION, LTD
UTSI|UTSTARCOM HOLDINGS CORP
VR|VALIDUS HOLDINGS, LTD.
VTG|VANTAGE DRILLING COMPANY
GLNG|GOLAR LNG LTD
WTM|WHITE MTNS INS GROUP LTD
WSH|WILLIS GROUP HOLDINGS PLC
XRTX|XYRATEX LIMITED
XL|XL GROUP PLC
ACE|ACE LIMITED
AWH|ALLIED WORLD ASSURANCE COMPANY
WFT|WEATHERFORD INTERNATIONAL LTD
FWLT|FOSTER WHEELER AG
GRMN|GARMIN LTD.
PNR|PENTAIR LTD
TEL|TE CONNECTIVITY LTD
TYC|TYCO INTERNATIONAL LTD
UBS|UBS AG
AGRO|ADECOAGRO S.A.
ASPS|ALTISOURCE PORTFOLIO SOL S.A.
MTCN|ARCELORMITTAL
I|INTELSAT S A
IPRA|INTELSAT INVESTMENTS S.A.
MIICF|MILLICOM INTL CELLULAR S.A.
PACD|PACIFIC DRILLING SA LUXEMBOURG
CSTE|CAESARSTONE SDOT-YAM LTD
CEL|CELLCOM ISRAEL LTD.
CHKP|CHECK POINT SOFTWARE TECH. LTD
CKSW|CLICKSOFTWARE TECHNOLOGIES LTD
GIVN|GIVEN IMAGING LTD
ITRN|ITURAN LOCATION & CONTROL LTD
NVMI|NOVA MEASURING INSTRUMENTS LTD
ORBK|ORBOTECH LTD (ORD)
RDWR|RADWARE LTD.
SSYS|STRATASYS LTD
ELOS|SYNERON MEDICAL LTD.
TARO|TARO PHARMACEUTICALS INDUS
AEF|AEGON N.V.
AER|AERCAP HOLDINGS NV
ASML|ASML HOLDING N.V.
AVG|AVG TECHNOLOGIES N.V.
CNHI|CNH INDUSTRIAL NV
CSTM|CONSTELLIUM HOLDCO B V
CLB|CORE LABORATORIES N.V.
INXN|INTERXION HOLDING N.V.
LYB|LYONDELLBASELL INDUSTRIES N.V.
NLSN|NIELSEN HOLDINGS N.V.
NXPI|NXP SEMICONDUCTORS N.V.
OFIX|ORTHOFIX INTERNATIONAL
QGEN|QIAGEN N.V.
ST|SENSATA TECHNOLOGIES HLDG N .V
TRNX|TORNIER N V
VPRT|VISTAPRINT NV
YNDX|YANDEX N.V.
BLX|BANCO LATINOAMERICANO EXPORT
CPA|COPA HOLDINGS, S.A.
STNR|STEINER LEISURE LIMITED
ULTR|ULTRAPETROL (BAHAMAS) LIMITED
TROX|TRONOX LIMITED
PLPM|PLANET PAYMENT INC
RCL|ROYAL CARIBBEAN CRUISES LTD
ANW|AEGEAN MARINE PETE NETWORK INC
ASC|ARDMORE SHIPPING CORP
AVGO|AVAGO TECHNOLOGIES LTD
DHT|DHT HOLDINGS INC
DSX|DIANA SHIPPING INC
FLEX|FLEXTRONICS INTERNATIONAL LTD
GSL|GLOBAL SHIP LEASE, INC.
GMLP|GOLAR LNG PARTNERS LP
NM|NAVIOS MARITIME HOLDINGS INC.
STNG|SCORPIO TANKERS INC.
GASS|STEALTHGAS INC.
TGP|TEEKAY LNG PARTNERS L.P.
TK|TEEKAY CORPORATION
TNK|TEEKAY TANKERS LTD.
F|3930
